Unnamed: 0,age,gender,year_in_school,major,monthly_income,financial_aid,tuition,housing,food,transportation,books_supplies,entertainment,personal_care,technology,health_wellness,miscellaneous,preferred_payment_method,personal_expenses,education_expenses,daily_essentials_expenses,discretionary_expenses
0,19,Non-binary,Freshman,Psychology,958,270,5939,709,296,123,188,41,78,134,127,72,Credit/Debit Card,205,6127,419,113
1,24,Female,Junior,Economics,1006,875,4908,557,365,85,252,74,92,226,129,68,Credit/Debit Card,221,5160,450,142
2,24,Non-binary,Junior,Economics,734,928,3051,666,220,137,99,130,23,239,112,133,Cash,135,3150,357,263
3,23,Female,Senior,Computer Science,617,265,4935,652,289,114,223,99,30,163,105,55,Mobile Payment App,135,5158,403,154
4,20,Female,Senior,Computer Science,810,522,3887,825,372,168,194,48,71,88,71,104,Credit/Debit Card,142,4081,540,152
5,25,Non-binary,Sophomore,Computer Science,523,790,3151,413,386,122,131,73,38,234,108,99,Mobile Payment App,146,3282,508,172
6,23,Female,Freshman,Engineering,1354,69,4973,812,398,101,213,21,38,157,117,48,Credit/Debit Card,155,5186,499,69
7,23,Female,Junior,Economics,631,748,3966,571,269,92,251,37,90,152,56,62,Mobile Payment App,146,4217,361,99
8,22,Non-binary,Senior,Computer Science,1402,248,5638,599,354,82,155,123,41,162,172,194,Credit/Debit Card,213,5793,436,317
9,18,Female,Junior,Computer Science,1423,74,3977,626,249,117,123,51,74,243,34,196,Mobile Payment App,108,4100,366,247
10,23,Male,Junior,Biology,762,615,4093,660,262,58,183,98,21,274,66,50,Credit/Debit Card,87,4276,320,148
11,25,Male,Freshman,Engineering,1068,19,5138,734,243,200,228,57,57,209,193,146,Credit/Debit Card,250,5366,443,203
12,21,Male,Sophomore,Economics,719,540,4863,894,280,120,126,41,50,78,113,114,Credit/Debit Card,163,4989,400,155
13,19,Female,Junior,Biology,1176,859,5201,626,234,50,274,20,77,125,199,103,Mobile Payment App,276,5475,284,123
14,24,Non-binary,Freshman,Economics,1496,75,5301,657,151,63,92,124,64,196,50,117,Cash,114,5393,214,241
15,22,Non-binary,Sophomore,Computer Science,1227,26,4175,884,328,167,175,111,96,73,154,109,Cash,250,4350,495,220
16,23,Female,Freshman,Psychology,1419,237,5450,883,361,200,141,76,22,285,185,76,Cash,207,5591,561,152
17,21,Female,Freshman,Computer Science,1454,851,3538,754,357,110,188,33,24,50,74,46,Mobile Payment App,98,3726,467,79
18,19,Female,Sophomore,Psychology,1487,311,4401,883,292,69,51,75,60,105,181,164,Credit/Debit Card,241,4452,361,239
19,20,Female,Senior,Engineering,1157,401,3131,886,196,131,216,57,39,264,39,174,Mobile Payment App,78,3347,327,231
20,19,Male,Junior,Psychology,1180,732,4206,597,254,195,67,51,21,97,185,46,Credit/Debit Card,206,4273,449,97
21,24,Male,Sophomore,Computer Science,516,549,4878,814,286,180,282,55,25,77,73,184,Mobile Payment App,98,5160,466,239
22,18,Non-binary,Sophomore,Biology,1225,610,4998,473,159,134,294,37,86,159,60,43,Cash,146,5292,293,80
23,24,Non-binary,Senior,Economics,582,285,4210,421,348,138,143,62,85,218,113,60,Credit/Debit Card,198,4353,486,122
24,19,Female,Senior,Economics,1062,56,4500,731,238,103,76,111,95,238,74,83,Mobile Payment App,169,4576,341,194
25,25,Female,Junior,Biology,1054,528,5486,789,400,81,211,95,74,237,140,136,Mobile Payment App,214,5697,481,231
26,20,Male,Senior,Economics,667,690,3541,762,173,185,288,53,38,84,159,137,Credit/Debit Card,197,3829,358,190
27,20,Female,Junior,Psychology,796,705,5616,664,291,179,260,127,21,113,194,80,Credit/Debit Card,215,5876,470,207
28,24,Non-binary,Sophomore,Psychology,905,671,4156,444,163,131,141,132,31,156,95,128,Credit/Debit Card,126,4297,294,260
29,23,Non-binary,Junior,Engineering,531,448,3099,742,394,179,95,64,62,73,104,173,Mobile Payment App,166,3194,573,237
30,23,Non-binary,Freshman,Economics,1426,3,5943,677,296,110,137,146,21,155,105,26,Mobile Payment App,126,6080,406,172
31,23,Male,Sophomore,Psychology,1465,302,5417,468,113,190,134,119,82,276,165,191,Mobile Payment App,247,5551,303,310
32,24,Non-binary,Junior,Computer Science,522,555,5236,860,169,133,147,123,48,138,89,150,Credit/Debit Card,137,5383,302,273
33,25,Female,Freshman,Economics,1338,110,5615,468,325,158,244,98,46,231,183,80,Cash,229,5859,483,178
34,23,Male,Junior,Biology,1363,365,3222,695,185,166,99,116,68,77,31,161,Mobile Payment App,99,3321,351,277
35,21,Male,Freshman,Biology,1328,320,3090,718,254,93,204,74,30,228,60,179,Cash,90,3294,347,253
36,22,Male,Sophomore,Engineering,1350,675,3931,462,372,147,282,149,92,269,105,190,Cash,197,4213,519,339
37,23,Non-binary,Senior,Computer Science,1309,265,5160,600,178,148,186,88,78,242,54,172,Cash,132,5346,326,260
38,21,Female,Senior,Biology,965,251,5344,695,249,88,249,49,29,298,96,31,Cash,125,5593,337,80
39,20,Female,Senior,Engineering,600,392,5733,791,309,178,67,22,29,142,74,105,Mobile Payment App,103,5800,487,127
40,24,Female,Freshman,Engineering,605,118,5696,653,165,189,151,86,82,117,83,156,Mobile Payment App,165,5847,354,242
41,25,Male,Sophomore,Economics,804,140,5332,517,289,147,153,125,43,159,44,127,Cash,87,5485,436,252
42,23,Female,Sophomore,Economics,1274,449,4639,755,137,55,249,103,50,176,67,175,Cash,117,4888,192,278
43,23,Male,Junior,Psychology,509,942,3958,511,391,192,264,57,85,108,115,141,Credit/Debit Card,200,4222,583,198
44,23,Female,Senior,Economics,1285,881,3823,740,253,182,230,32,92,118,34,39,Credit/Debit Card,126,4053,435,71
45,18,Male,Freshman,Computer Science,929,348,3854,590,204,196,183,129,80,163,116,55,Credit/Debit Card,196,4037,400,184
46,25,Non-binary,Freshman,Psychology,1163,235,4951,549,261,86,185,102,21,252,31,88,Cash,52,5136,347,190
47,19,Male,Senior,Psychology,1195,745,5269,920,167,57,88,113,60,242,35,106,Mobile Payment App,95,5357,224,219
48,25,Male,Junior,Psychology,1036,260,4141,918,122,86,105,62,88,90,169,137,Cash,257,4246,208,199
49,24,Female,Junior,Economics,588,211,4875,604,163,101,198,89,23,128,62,42,Mobile Payment App,85,5073,264,131
50,20,Female,Junior,Engineering,1377,723,5414,786,355,137,187,45,90,145,200,27,Cash,290,5601,492,72
51,21,Non-binary,Freshman,Economics,1451,479,5481,661,140,67,128,31,48,293,37,128,Credit/Debit Card,85,5609,207,159
52,19,Male,Senior,Computer Science,669,660,3823,837,193,115,75,121,65,150,96,58,Cash,161,3898,308,179
53,18,Male,Freshman,Psychology,1294,818,4079,806,115,97,71,24,31,79,107,63,Mobile Payment App,138,4150,212,87
54,24,Non-binary,Senior,Engineering,941,90,3688,963,372,197,146,32,86,109,45,198,Mobile Payment App,131,3834,569,230
55,22,Female,Sophomore,Engineering,1131,312,4244,926,339,142,237,145,93,121,91,158,Cash,184,4481,481,303
56,24,Non-binary,Freshman,Computer Science,854,700,4824,525,223,145,133,47,91,294,191,170,Cash,282,4957,368,217
57,20,Male,Sophomore,Economics,1158,653,3017,960,216,193,299,40,61,263,55,141,Mobile Payment App,116,3316,409,181
58,25,Non-binary,Sophomore,Biology,668,50,3650,466,377,161,221,60,80,180,142,86,Mobile Payment App,222,3871,538,146
59,20,Female,Junior,Biology,695,970,4694,626,304,104,200,47,71,223,93,191,Mobile Payment App,164,4894,408,238
60,20,Male,Junior,Engineering,1375,722,5389,416,132,193,149,67,27,261,46,43,Mobile Payment App,73,5538,325,110
61,23,Female,Junior,Engineering,1084,315,5205,721,230,76,141,86,34,187,159,144,Mobile Payment App,193,5346,306,230
62,18,Female,Senior,Biology,733,838,5248,977,298,164,241,85,78,281,121,168,Cash,199,5489,462,253
63,20,Non-binary,Freshman,Economics,1061,989,5194,464,370,58,77,135,34,124,40,171,Mobile Payment App,74,5271,428,306
64,19,Female,Junior,Computer Science,1352,13,3403,477,144,82,190,109,84,81,56,80,Mobile Payment App,140,3593,226,189
65,19,Male,Freshman,Biology,1092,550,5841,916,150,143,257,90,29,262,192,177,Mobile Payment App,221,6098,293,267
66,24,Male,Freshman,Economics,963,367,3830,883,260,79,139,135,64,54,81,74,Mobile Payment App,145,3969,339,209
67,21,Female,Junior,Engineering,1204,121,4261,488,283,111,287,115,56,230,85,24,Credit/Debit Card,141,4548,394,139
68,23,Male,Senior,Engineering,1184,104,5380,940,115,185,171,58,45,111,30,169,Mobile Payment App,75,5551,300,227
69,22,Male,Junior,Economics,562,728,4560,986,306,105,109,90,99,187,195,34,Mobile Payment App,294,4669,411,124
70,19,Male,Freshman,Economics,1218,878,4643,451,234,169,240,105,21,238,101,38,Mobile Payment App,122,4883,403,143
71,21,Non-binary,Sophomore,Computer Science,1235,805,5442,745,390,150,228,96,80,104,35,131,Cash,115,5670,540,227
72,23,Non-binary,Sophomore,Economics,1424,367,3220,684,328,118,91,143,88,98,159,54,Cash,247,3311,446,197
73,22,Female,Freshman,Biology,1176,804,4272,861,305,97,106,103,43,185,104,67,Mobile Payment App,147,4378,402,170
74,25,Female,Sophomore,Engineering,1334,81,3986,873,180,186,236,23,61,88,87,33,Credit/Debit Card,148,4222,366,56
75,19,Female,Senior,Computer Science,1442,354,5371,733,153,166,105,29,80,86,137,109,Cash,217,5476,319,138
76,22,Male,Sophomore,Computer Science,983,862,5650,648,159,128,259,124,97,96,150,134,Cash,247,5909,287,258
77,24,Female,Sophomore,Computer Science,914,24,4881,564,149,55,61,129,79,180,94,33,Credit/Debit Card,173,4942,204,162
78,22,Non-binary,Senior,Economics,898,155,5428,868,175,129,148,114,74,196,104,77,Cash,178,5576,304,191
79,23,Non-binary,Junior,Economics,1164,357,5212,631,331,125,199,115,48,130,107,196,Cash,155,5411,456,311
80,18,Female,Freshman,Biology,1484,594,4636,518,299,74,55,104,87,122,171,193,Mobile Payment App,258,4691,373,297
81,19,Female,Junior,Biology,1127,850,5104,623,385,94,193,29,57,259,113,31,Mobile Payment App,170,5297,479,60
82,24,Non-binary,Senior,Biology,1105,671,5501,841,235,164,109,144,100,252,198,36,Cash,298,5610,399,180
83,19,Male,Freshman,Computer Science,1351,156,4529,678,186,178,75,34,95,97,140,75,Mobile Payment App,235,4604,364,109
84,22,Female,Freshman,Biology,930,768,3050,490,349,54,174,80,51,278,143,41,Mobile Payment App,194,3224,403,121
85,25,Non-binary,Senior,Computer Science,1346,932,5683,718,376,152,156,94,81,220,145,83,Credit/Debit Card,226,5839,528,177
86,25,Non-binary,Sophomore,Computer Science,1240,44,3901,618,315,177,180,41,63,247,112,138,Credit/Debit Card,175,4081,492,179
87,25,Female,Junior,Computer Science,727,143,4051,840,269,119,121,132,40,173,198,125,Credit/Debit Card,238,4172,388,257
88,20,Female,Junior,Economics,622,959,4707,431,234,184,264,54,84,295,162,177,Mobile Payment App,246,4971,418,231
89,23,Male,Sophomore,Economics,800,933,5304,421,144,97,51,103,66,247,183,92,Credit/Debit Card,249,5355,241,195
90,18,Non-binary,Junior,Psychology,1199,516,5959,778,260,82,238,74,82,149,126,62,Credit/Debit Card,208,6197,342,136
91,19,Male,Senior,Economics,1006,392,3526,411,357,109,268,107,94,65,138,145,Cash,232,3794,466,252
92,23,Non-binary,Sophomore,Economics,1295,903,4423,791,397,144,64,59,79,187,189,113,Mobile Payment App,268,4487,541,172
93,18,Male,Sophomore,Economics,1222,625,4236,862,127,180,63,91,90,191,87,122,Mobile Payment App,177,4299,307,213
94,18,Female,Senior,Computer Science,1384,800,4822,809,237,174,85,21,72,130,185,104,Credit/Debit Card,257,4907,411,125
95,18,Female,Junior,Engineering,1035,513,3367,760,182,57,95,119,21,166,149,119,Credit/Debit Card,170,3462,239,238
96,20,Male,Freshman,Economics,1395,723,5126,551,258,130,81,102,84,234,172,78,Credit/Debit Card,256,5207,388,180
97,18,Non-binary,Sophomore,Biology,767,457,5096,780,331,200,115,89,27,265,175,158,Credit/Debit Card,202,5211,531,247
98,24,Female,Senior,Biology,933,452,4706,787,166,136,106,112,63,270,86,29,Cash,149,4812,302,141
99,23,Male,Junior,Psychology,803,796,3471,931,293,54,146,142,58,84,104,41,Mobile Payment App,162,3617,347,183
100,22,Male,Sophomore,Psychology,1333,231,3300,971,295,51,219,91,94,259,161,50,Cash,255,3519,346,141
101,23,Female,Senior,Psychology,1115,437,5317,818,341,136,116,115,22,56,38,106,Mobile Payment App,60,5433,477,221
102,20,Female,Sophomore,Psychology,920,149,3366,636,295,143,77,120,96,137,162,178,Cash,258,3443,438,298
103,25,Male,Junior,Psychology,780,95,5931,759,216,99,251,20,38,192,105,97,Cash,143,6182,315,117
104,21,Female,Junior,Psychology,882,912,5570,555,305,103,81,112,28,112,162,197,Mobile Payment App,190,5651,408,309
105,21,Female,Senior,Computer Science,959,258,3200,464,360,153,220,26,88,144,161,134,Cash,249,3420,513,160
106,25,Female,Senior,Psychology,748,494,4789,447,353,164,201,60,43,99,93,172,Mobile Payment App,136,4990,517,232
107,21,Male,Junior,Biology,810,73,4884,742,112,173,276,136,63,294,161,136,Mobile Payment App,224,5160,285,272
108,20,Male,Sophomore,Computer Science,965,322,4992,433,175,56,71,89,74,66,59,130,Mobile Payment App,133,5063,231,219
109,24,Male,Senior,Psychology,784,513,4906,863,116,110,140,116,56,264,179,160,Credit/Debit Card,235,5046,226,276
110,22,Male,Sophomore,Economics,970,553,5894,680,344,156,114,120,79,53,40,156,Mobile Payment App,119,6008,500,276
111,23,Non-binary,Senior,Economics,1349,873,5866,661,205,129,88,72,28,192,72,101,Credit/Debit Card,100,5954,334,173
112,19,Female,Senior,Psychology,760,61,5429,831,268,84,63,26,92,278,185,60,Credit/Debit Card,277,5492,352,86
113,21,Female,Freshman,Computer Science,702,273,4977,906,385,106,277,148,41,205,149,116,Cash,190,5254,491,264
114,21,Male,Junior,Engineering,720,675,5309,661,284,95,153,93,21,108,81,64,Mobile Payment App,102,5462,379,157
115,22,Male,Freshman,Biology,1286,789,3618,902,343,194,182,74,62,171,126,112,Mobile Payment App,188,3800,537,186
116,22,Female,Sophomore,Engineering,1135,261,4753,629,335,168,97,113,60,223,44,62,Cash,104,4850,503,175
117,18,Non-binary,Senior,Engineering,1030,240,3108,859,386,147,208,27,60,265,36,23,Credit/Debit Card,96,3316,533,50
118,21,Female,Senior,Engineering,1265,722,4579,760,122,122,63,34,48,250,153,184,Credit/Debit Card,201,4642,244,218
119,24,Female,Freshman,Psychology,1175,803,5634,444,290,170,63,25,37,275,111,101,Mobile Payment App,148,5697,460,126
120,23,Female,Freshman,Psychology,1083,10,5275,640,236,153,257,62,87,188,55,59,Mobile Payment App,142,5532,389,121
121,24,Non-binary,Freshman,Biology,1487,940,3167,765,202,146,183,145,23,233,120,44,Mobile Payment App,143,3350,348,189
122,25,Non-binary,Junior,Computer Science,1327,196,5067,613,278,179,187,149,38,227,162,104,Cash,200,5254,457,253
123,22,Non-binary,Senior,Economics,1095,165,4532,801,253,167,243,73,33,110,66,98,Credit/Debit Card,99,4775,420,171
124,23,Male,Senior,Biology,1460,436,3230,787,377,176,158,117,78,299,84,43,Mobile Payment App,162,3388,553,160
125,20,Female,Freshman,Engineering,1354,427,3691,515,224,120,125,71,46,140,184,177,Credit/Debit Card,230,3816,344,248
126,20,Male,Sophomore,Biology,836,620,4311,584,301,160,193,91,46,143,120,53,Cash,166,4504,461,144
127,22,Male,Junior,Engineering,1212,529,4012,897,400,53,120,117,88,284,119,105,Credit/Debit Card,207,4132,453,222
128,20,Non-binary,Senior,Engineering,1483,277,3413,554,182,138,275,72,35,160,74,190,Credit/Debit Card,109,3688,320,262
129,22,Non-binary,Sophomore,Computer Science,998,935,5420,516,297,96,103,129,78,251,109,63,Credit/Debit Card,187,5523,393,192
130,22,Non-binary,Senior,Biology,885,325,4389,907,317,144,126,149,89,243,156,81,Credit/Debit Card,245,4515,461,230
131,25,Male,Senior,Engineering,726,333,3854,738,177,195,110,92,77,117,30,50,Credit/Debit Card,107,3964,372,142
132,25,Female,Junior,Psychology,1037,990,4885,481,367,130,272,56,57,150,92,22,Mobile Payment App,149,5157,497,78
133,22,Female,Freshman,Engineering,1456,993,3377,733,201,94,284,123,34,59,77,97,Mobile Payment App,111,3661,295,220
134,24,Male,Junior,Economics,676,183,4129,600,135,75,227,25,22,200,164,133,Mobile Payment App,186,4356,210,158
135,24,Female,Senior,Psychology,571,215,5579,424,133,149,139,29,58,275,173,109,Mobile Payment App,231,5718,282,138
136,23,Male,Junior,Computer Science,1213,761,5944,768,246,196,165,52,68,198,180,40,Mobile Payment App,248,6109,442,92
137,24,Female,Sophomore,Psychology,1112,547,5305,498,357,170,183,92,84,138,92,197,Cash,176,5488,527,289
138,18,Female,Sophomore,Economics,1100,535,4834,593,201,197,78,92,44,178,198,45,Credit/Debit Card,242,4912,398,137
139,21,Male,Sophomore,Psychology,526,375,4279,747,159,183,197,67,21,88,58,108,Cash,79,4476,342,175
140,22,Male,Junior,Computer Science,951,202,3172,818,158,68,95,76,63,122,47,96,Mobile Payment App,110,3267,226,172
141,23,Male,Sophomore,Computer Science,1301,163,5696,899,117,51,278,22,22,153,70,150,Cash,92,5974,168,172
142,25,Male,Junior,Psychology,1103,5,5960,676,375,149,133,76,33,212,165,169,Mobile Payment App,198,6093,524,245
143,24,Male,Senior,Computer Science,1083,466,5692,644,111,80,235,76,42,108,65,73,Cash,107,5927,191,149
144,23,Female,Senior,Engineering,860,47,3057,614,235,115,117,71,72,226,94,126,Cash,166,3174,350,197
145,18,Male,Senior,Biology,1354,882,3341,969,348,75,126,49,93,201,116,178,Cash,209,3467,423,227
146,23,Male,Senior,Biology,877,847,4768,465,221,96,52,39,73,94,141,64,Credit/Debit Card,214,4820,317,103
147,21,Male,Freshman,Engineering,649,577,3046,931,224,161,200,24,80,213,135,180,Credit/Debit Card,215,3246,385,204
148,24,Male,Sophomore,Computer Science,897,220,4655,799,358,125,290,80,23,156,177,46,Credit/Debit Card,200,4945,483,126
149,21,Non-binary,Freshman,Psychology,1147,872,3709,581,102,188,225,98,72,273,126,166,Mobile Payment App,198,3934,290,264
150,23,Non-binary,Senior,Biology,1367,606,5577,916,260,78,213,145,71,223,123,199,Credit/Debit Card,194,5790,338,344
151,21,Male,Freshman,Computer Science,647,382,4943,807,149,61,214,136,26,191,102,107,Cash,128,5157,210,243
152,21,Female,Senior,Engineering,656,725,3360,931,329,188,95,120,92,102,59,198,Credit/Debit Card,151,3455,517,318
153,19,Non-binary,Junior,Economics,1131,315,3194,468,328,177,118,26,69,66,161,120,Mobile Payment App,230,3312,505,146
154,19,Female,Freshman,Psychology,1319,803,4160,677,159,73,229,140,38,108,175,31,Cash,213,4389,232,171
155,22,Female,Freshman,Economics,917,856,5010,434,128,184,277,98,29,115,61,66,Credit/Debit Card,90,5287,312,164
156,19,Female,Sophomore,Biology,872,206,5309,944,232,166,153,58,64,67,167,86,Credit/Debit Card,231,5462,398,144
157,20,Male,Sophomore,Economics,901,115,3388,737,295,84,297,66,80,146,100,93,Mobile Payment App,180,3685,379,159
158,18,Male,Junior,Engineering,536,535,5547,676,255,82,111,128,35,252,160,79,Credit/Debit Card,195,5658,337,207
159,25,Female,Senior,Psychology,506,931,4087,998,251,175,80,82,82,76,152,56,Mobile Payment App,234,4167,426,138
160,23,Female,Junior,Economics,1201,635,3748,459,291,56,199,100,81,290,135,131,Credit/Debit Card,216,3947,347,231
161,25,Non-binary,Senior,Computer Science,1189,48,5568,815,159,79,66,113,68,91,94,37,Cash,162,5634,238,150
162,23,Female,Junior,Economics,546,387,3890,747,282,140,53,35,38,67,75,181,Credit/Debit Card,113,3943,422,216
163,19,Non-binary,Senior,Biology,1181,989,3162,559,196,137,89,46,60,249,134,200,Cash,194,3251,333,246
164,18,Female,Sophomore,Economics,810,292,3953,771,340,51,98,120,88,133,58,113,Cash,146,4051,391,233
165,19,Non-binary,Freshman,Engineering,855,397,4028,633,400,146,174,148,42,77,153,122,Cash,195,4202,546,270
166,23,Male,Sophomore,Biology,1354,17,5911,631,385,160,112,34,32,225,173,60,Cash,205,6023,545,94
167,20,Male,Freshman,Psychology,1056,861,5433,405,183,194,187,61,66,144,107,22,Cash,173,5620,377,83
168,19,Male,Freshman,Economics,620,215,4981,704,243,197,285,135,83,192,36,197,Credit/Debit Card,119,5266,440,332
169,24,Female,Freshman,Economics,1207,339,4361,638,201,143,241,112,29,86,139,110,Cash,168,4602,344,222
170,21,Non-binary,Sophomore,Psychology,621,456,5893,960,199,124,278,115,48,193,178,68,Cash,226,6171,323,183
171,25,Female,Senior,Engineering,1033,64,4249,517,104,64,259,131,66,234,63,104,Mobile Payment App,129,4508,168,235
172,19,Non-binary,Freshman,Psychology,722,2,3701,450,102,82,267,38,65,129,186,125,Mobile Payment App,251,3968,184,163
173,20,Male,Freshman,Psychology,1304,76,3564,847,180,92,300,90,64,113,34,113,Mobile Payment App,98,3864,272,203
174,21,Non-binary,Junior,Biology,912,970,3424,991,348,181,86,134,70,175,40,184,Credit/Debit Card,110,3510,529,318
175,23,Male,Sophomore,Biology,963,871,4951,778,253,105,135,124,46,185,164,160,Cash,210,5086,358,284
176,18,Female,Junior,Engineering,1286,618,3015,925,103,129,56,50,93,215,43,105,Mobile Payment App,136,3071,232,155
177,18,Male,Freshman,Economics,1104,180,4653,683,362,185,90,79,91,91,99,64,Credit/Debit Card,190,4743,547,143
178,23,Non-binary,Senior,Economics,697,927,3756,734,394,192,109,80,73,247,69,195,Cash,142,3865,586,275
179,21,Male,Freshman,Engineering,1230,968,4254,540,285,99,169,101,57,77,87,43,Cash,144,4423,384,144
180,25,Female,Junior,Engineering,1345,649,3889,919,311,133,68,149,66,69,159,162,Mobile Payment App,225,3957,444,311
181,20,Female,Junior,Biology,1411,517,3074,874,151,77,219,21,44,280,57,176,Mobile Payment App,101,3293,228,197
182,24,Female,Freshman,Economics,1355,282,5998,617,311,79,264,35,73,254,131,164,Credit/Debit Card,204,6262,390,199
183,24,Non-binary,Junior,Economics,608,918,4056,568,336,186,159,82,89,251,166,142,Mobile Payment App,255,4215,522,224
184,22,Female,Senior,Biology,566,480,3542,834,360,64,289,48,86,226,132,120,Credit/Debit Card,218,3831,424,168
185,25,Female,Junior,Economics,1310,982,4548,837,219,60,72,82,51,260,30,171,Mobile Payment App,81,4620,279,253
186,24,Female,Sophomore,Biology,1354,52,3169,849,335,60,199,77,45,101,195,125,Credit/Debit Card,240,3368,395,202
187,23,Male,Sophomore,Economics,1020,17,4645,943,305,156,240,123,53,290,77,63,Cash,130,4885,461,186
188,24,Non-binary,Senior,Engineering,1394,871,4450,416,268,133,146,22,68,172,126,185,Cash,194,4596,401,207
189,22,Non-binary,Sophomore,Psychology,954,337,5756,717,159,195,196,138,26,154,160,85,Credit/Debit Card,186,5952,354,223
190,21,Male,Senior,Biology,1448,794,3959,624,171,172,103,59,89,206,182,158,Mobile Payment App,271,4062,343,217
191,21,Non-binary,Sophomore,Biology,968,8,4078,670,108,56,129,26,66,272,64,151,Credit/Debit Card,130,4207,164,177
192,19,Male,Freshman,Economics,1450,809,4103,845,255,89,136,110,85,183,85,110,Credit/Debit Card,170,4239,344,220
193,22,Female,Freshman,Computer Science,1316,938,4316,953,153,179,229,105,66,184,151,137,Credit/Debit Card,217,4545,332,242
194,24,Male,Freshman,Computer Science,904,955,4075,875,310,197,201,91,83,224,186,101,Cash,269,4276,507,192
195,23,Female,Junior,Computer Science,1488,77,5418,545,112,193,158,21,64,257,168,86,Cash,232,5576,305,107
196,20,Female,Junior,Psychology,893,258,5877,469,131,192,222,73,84,125,176,74,Cash,260,6099,323,147
197,21,Male,Freshman,Biology,527,851,4464,683,390,194,185,127,65,188,168,193,Credit/Debit Card,233,4649,584,320
198,24,Male,Senior,Biology,804,640,3043,927,347,167,151,114,35,206,94,169,Credit/Debit Card,129,3194,514,283
199,25,Female,Junior,Engineering,547,233,5070,633,164,94,147,123,25,236,116,37,Credit/Debit Card,141,5217,258,160
200,19,Non-binary,Freshman,Computer Science,523,892,4683,438,180,65,208,108,59,192,92,132,Cash,151,4891,245,240
201,24,Female,Senior,Economics,1040,970,5293,701,323,97,196,93,62,170,90,64,Credit/Debit Card,152,5489,420,157
202,24,Male,Freshman,Computer Science,918,273,3012,759,113,181,62,99,81,226,155,199,Credit/Debit Card,236,3074,294,298
203,23,Female,Junior,Biology,504,775,4132,997,237,69,199,111,58,62,195,195,Credit/Debit Card,253,4331,306,306
204,24,Female,Senior,Economics,1203,115,3234,858,249,157,292,132,94,278,66,49,Cash,160,3526,406,181
205,20,Female,Senior,Psychology,951,279,4004,453,366,121,287,71,65,207,129,122,Mobile Payment App,194,4291,487,193
206,24,Non-binary,Sophomore,Psychology,857,583,3939,587,147,126,160,117,85,98,69,143,Mobile Payment App,154,4099,273,260
207,19,Male,Senior,Psychology,812,539,3191,744,108,189,296,31,81,204,87,34,Cash,168,3487,297,65
208,18,Male,Sophomore,Computer Science,540,649,5188,746,173,147,113,139,29,103,73,118,Credit/Debit Card,102,5301,320,257
209,19,Non-binary,Junior,Psychology,889,483,3007,673,225,113,113,148,40,256,171,175,Cash,211,3120,338,323
210,18,Non-binary,Freshman,Psychology,992,680,5718,533,241,84,276,65,81,141,171,51,Credit/Debit Card,252,5994,325,116
211,21,Male,Junior,Biology,760,869,3712,567,291,94,86,141,97,55,165,44,Mobile Payment App,262,3798,385,185
212,25,Male,Sophomore,Biology,1199,996,4865,533,207,123,70,104,76,256,189,192,Credit/Debit Card,265,4935,330,296
213,20,Female,Junior,Biology,578,460,4893,488,139,168,58,105,92,177,183,92,Credit/Debit Card,275,4951,307,197
214,24,Female,Senior,Economics,994,940,4885,487,143,54,79,74,53,77,66,22,Cash,119,4964,197,96
215,18,Non-binary,Junior,Economics,552,481,5312,937,307,77,71,21,52,127,46,77,Mobile Payment App,98,5383,384,98
216,21,Male,Junior,Computer Science,1444,792,5866,607,396,189,125,76,80,59,79,78,Credit/Debit Card,159,5991,585,154
217,19,Female,Junior,Psychology,1203,550,3282,654,182,108,288,147,38,92,182,128,Mobile Payment App,220,3570,290,275
218,25,Female,Sophomore,Computer Science,1481,50,4898,982,157,162,159,30,76,225,99,166,Credit/Debit Card,175,5057,319,196
219,25,Non-binary,Sophomore,Economics,700,174,5318,846,206,108,284,70,23,220,169,142,Credit/Debit Card,192,5602,314,212
220,25,Female,Junior,Economics,1087,415,5282,503,155,186,116,31,31,108,141,200,Mobile Payment App,172,5398,341,231
221,23,Male,Senior,Economics,672,699,4520,435,153,180,61,75,56,248,195,82,Mobile Payment App,251,4581,333,157
222,21,Male,Sophomore,Computer Science,825,882,4307,589,181,54,89,113,55,266,34,176,Credit/Debit Card,89,4396,235,289
223,24,Male,Sophomore,Computer Science,1033,267,5997,806,374,86,229,78,31,139,153,77,Cash,184,6226,460,155
224,25,Non-binary,Freshman,Engineering,774,250,5306,942,324,73,271,107,77,92,80,66,Credit/Debit Card,157,5577,397,173
225,23,Male,Junior,Engineering,1365,744,3066,936,265,52,121,46,85,292,128,115,Credit/Debit Card,213,3187,317,161
226,25,Non-binary,Sophomore,Economics,810,826,3709,938,206,180,112,82,45,165,110,98,Mobile Payment App,155,3821,386,180
227,22,Male,Sophomore,Economics,856,33,5420,967,391,112,196,43,71,294,91,139,Mobile Payment App,162,5616,503,182
228,21,Female,Senior,Psychology,985,586,4345,481,110,141,135,103,42,270,194,196,Credit/Debit Card,236,4480,251,299
229,22,Non-binary,Junior,Biology,919,369,4599,788,119,170,58,124,34,97,64,185,Credit/Debit Card,98,4657,289,309
230,18,Female,Sophomore,Biology,637,130,5152,559,340,62,226,42,72,244,197,42,Cash,269,5378,402,84
231,20,Male,Freshman,Economics,894,327,3535,689,213,127,69,116,50,143,81,51,Credit/Debit Card,131,3604,340,167
232,22,Female,Senior,Economics,874,561,3452,504,299,111,237,113,71,104,45,62,Cash,116,3689,410,175
233,22,Female,Junior,Computer Science,850,699,3180,777,196,102,212,98,75,192,48,106,Credit/Debit Card,123,3392,298,204
234,24,Non-binary,Junior,Engineering,879,865,5743,921,249,189,222,111,71,112,60,133,Credit/Debit Card,131,5965,438,244
235,24,Female,Junior,Economics,811,346,3527,795,308,106,74,126,23,299,111,152,Credit/Debit Card,134,3601,414,278
236,21,Male,Sophomore,Computer Science,809,768,4079,505,186,176,217,70,81,194,193,91,Cash,274,4296,362,161
237,18,Non-binary,Senior,Psychology,596,316,5494,567,308,54,126,149,46,278,134,21,Credit/Debit Card,180,5620,362,170
238,25,Male,Sophomore,Economics,856,102,3647,500,341,123,198,85,73,208,58,21,Mobile Payment App,131,3845,464,106
239,25,Male,Senior,Computer Science,886,143,3489,676,219,61,198,99,95,178,46,188,Mobile Payment App,141,3687,280,287
240,24,Female,Sophomore,Psychology,1205,715,5781,428,346,190,79,37,28,57,182,133,Mobile Payment App,210,5860,536,170
241,21,Non-binary,Freshman,Biology,1353,444,4343,622,341,198,152,106,44,236,60,171,Cash,104,4495,539,277
242,22,Male,Junior,Computer Science,1268,886,4960,917,100,53,102,98,66,228,124,176,Cash,190,5062,153,274
243,23,Non-binary,Sophomore,Psychology,1112,5,3873,737,188,101,266,46,76,73,190,159,Cash,266,4139,289,205
244,20,Female,Junior,Engineering,1206,639,5211,720,363,66,120,134,85,152,52,30,Cash,137,5331,429,164
245,24,Male,Junior,Biology,1159,465,3153,891,226,55,95,46,58,284,41,88,Mobile Payment App,99,3248,281,134
246,19,Non-binary,Sophomore,Biology,1250,113,4859,521,305,92,133,77,92,69,108,116,Mobile Payment App,200,4992,397,193
247,20,Non-binary,Freshman,Computer Science,1120,327,5509,670,120,130,178,52,71,267,38,63,Mobile Payment App,109,5687,250,115
248,24,Non-binary,Senior,Computer Science,1277,520,4706,538,374,183,243,80,74,246,152,46,Cash,226,4949,557,126
249,19,Male,Freshman,Psychology,1442,463,5284,537,307,157,113,60,39,261,178,115,Mobile Payment App,217,5397,464,175
250,24,Non-binary,Junior,Biology,776,16,4353,460,358,95,219,27,61,178,173,168,Cash,234,4572,453,195
251,21,Female,Sophomore,Biology,800,311,3641,438,331,60,125,22,41,253,45,78,Mobile Payment App,86,3766,391,100
252,18,Female,Junior,Computer Science,1078,910,5416,507,232,175,64,129,55,136,156,52,Credit/Debit Card,211,5480,407,181
253,20,Male,Junior,Computer Science,1404,747,3920,760,237,104,122,28,82,115,75,56,Mobile Payment App,157,4042,341,84
254,21,Non-binary,Junior,Psychology,1097,70,4255,447,101,125,267,119,58,76,37,94,Credit/Debit Card,95,4522,226,213
255,22,Non-binary,Freshman,Biology,835,244,3098,834,380,95,243,39,51,178,101,110,Credit/Debit Card,152,3341,475,149
256,18,Non-binary,Senior,Economics,755,757,3221,820,301,126,231,77,71,284,99,111,Credit/Debit Card,170,3452,427,188
257,19,Male,Freshman,Engineering,1087,133,5170,872,133,86,177,73,63,198,167,32,Credit/Debit Card,230,5347,219,105
258,23,Male,Sophomore,Computer Science,931,950,3012,636,329,187,96,141,96,246,193,121,Cash,289,3108,516,262
259,20,Female,Sophomore,Psychology,983,321,4912,761,350,177,256,61,73,206,63,179,Credit/Debit Card,136,5168,527,240
260,21,Non-binary,Sophomore,Engineering,639,854,4160,676,174,107,208,71,48,231,192,169,Mobile Payment App,240,4368,281,240
261,20,Male,Junior,Engineering,527,438,4231,961,212,60,287,57,31,80,162,40,Mobile Payment App,193,4518,272,97
262,24,Male,Junior,Computer Science,744,666,4930,853,134,115,197,107,73,256,117,34,Mobile Payment App,190,5127,249,141
263,21,Male,Freshman,Economics,1118,367,3821,956,287,112,267,65,92,147,149,50,Mobile Payment App,241,4088,399,115
264,22,Male,Senior,Engineering,1276,606,3809,970,124,97,271,96,81,110,136,42,Credit/Debit Card,217,4080,221,138
265,25,Female,Junior,Engineering,880,863,4771,903,291,100,292,108,55,217,164,51,Cash,219,5063,391,159
266,23,Male,Freshman,Engineering,1424,887,4645,854,140,145,156,35,36,50,114,153,Mobile Payment App,150,4801,285,188
267,22,Female,Senior,Psychology,1276,500,3568,785,338,144,298,91,64,173,98,109,Mobile Payment App,162,3866,482,200
268,19,Non-binary,Junior,Computer Science,697,943,5958,824,274,200,89,56,31,268,175,96,Mobile Payment App,206,6047,474,152
269,23,Non-binary,Senior,Computer Science,1379,500,3665,946,114,143,211,92,20,83,113,110,Mobile Payment App,133,3876,257,202
270,20,Female,Freshman,Computer Science,1466,977,5400,698,283,135,58,135,96,171,30,85,Credit/Debit Card,126,5458,418,220
271,24,Male,Junior,Biology,1126,649,3565,483,259,63,53,57,43,65,40,86,Cash,83,3618,322,143
272,23,Non-binary,Senior,Biology,1126,9,5535,1000,206,135,84,70,95,295,120,73,Cash,215,5619,341,143
273,21,Non-binary,Senior,Biology,618,916,4952,459,192,145,202,86,81,122,150,113,Cash,231,5154,337,199
274,22,Non-binary,Junior,Biology,785,303,3495,407,245,64,92,47,82,94,104,184,Mobile Payment App,186,3587,309,231
275,18,Non-binary,Senior,Computer Science,770,554,3535,468,171,104,93,75,22,74,191,182,Cash,213,3628,275,257
276,25,Non-binary,Sophomore,Psychology,1431,856,5216,528,377,155,191,149,56,117,124,173,Credit/Debit Card,180,5407,532,322
277,18,Female,Freshman,Biology,1338,491,3955,781,100,139,175,129,24,167,149,137,Credit/Debit Card,173,4130,239,266
278,25,Female,Sophomore,Psychology,1121,794,3517,407,363,101,170,60,30,168,101,124,Mobile Payment App,131,3687,464,184
279,24,Female,Freshman,Engineering,1245,675,5833,944,195,107,88,79,95,166,199,122,Credit/Debit Card,294,5921,302,201
280,20,Female,Senior,Computer Science,748,223,3343,919,100,142,266,77,60,103,199,87,Mobile Payment App,259,3609,242,164
281,20,Female,Junior,Biology,1389,477,3610,811,152,91,234,82,33,171,96,31,Credit/Debit Card,129,3844,243,113
282,19,Female,Junior,Engineering,1122,790,5969,840,365,104,134,64,98,201,57,168,Credit/Debit Card,155,6103,469,232
283,23,Male,Senior,Psychology,1113,955,5456,773,349,178,79,135,78,200,135,127,Cash,213,5535,527,262
284,20,Female,Sophomore,Economics,879,547,5055,407,169,105,280,90,62,238,82,172,Cash,144,5335,274,262
285,18,Non-binary,Freshman,Economics,1489,202,4710,921,101,187,122,130,38,246,96,193,Mobile Payment App,134,4832,288,323
286,22,Female,Freshman,Biology,869,85,5866,754,379,127,214,111,64,276,37,105,Cash,101,6080,506,216
287,23,Male,Junior,Psychology,1381,520,5066,624,356,65,97,55,84,106,65,51,Mobile Payment App,149,5163,421,106
288,21,Non-binary,Sophomore,Biology,1325,735,4012,880,270,200,230,121,97,248,102,157,Cash,199,4242,470,278
289,20,Male,Senior,Psychology,581,492,3705,448,318,114,186,129,85,215,188,100,Cash,273,3891,432,229
290,22,Non-binary,Senior,Engineering,694,245,4140,692,398,92,215,25,92,247,135,28,Mobile Payment App,227,4355,490,53
291,24,Female,Sophomore,Economics,615,563,3389,403,200,109,63,145,79,233,64,153,Mobile Payment App,143,3452,309,298
292,25,Female,Sophomore,Economics,1394,519,4998,879,222,84,141,21,67,96,101,111,Credit/Debit Card,168,5139,306,132
293,25,Female,Freshman,Biology,800,223,5867,828,298,94,166,127,81,229,48,71,Credit/Debit Card,129,6033,392,198
294,20,Male,Senior,Psychology,913,634,3541,668,375,187,171,70,91,90,133,200,Cash,224,3712,562,270
295,19,Male,Sophomore,Psychology,1243,882,5570,574,106,190,73,85,97,264,94,82,Mobile Payment App,191,5643,296,167
296,20,Female,Sophomore,Economics,655,685,3115,481,270,157,133,97,22,112,80,98,Credit/Debit Card,102,3248,427,195
297,18,Male,Freshman,Biology,667,647,4637,906,225,123,204,81,36,89,33,137,Credit/Debit Card,69,4841,348,218
298,24,Non-binary,Senior,Economics,1458,7,5143,505,329,140,265,138,65,81,49,198,Credit/Debit Card,114,5408,469,336
299,22,Non-binary,Sophomore,Biology,925,350,4445,529,227,51,173,132,24,58,183,74,Mobile Payment App,207,4618,278,206
300,21,Non-binary,Senior,Economics,1105,35,4114,417,308,178,152,142,90,286,84,139,Credit/Debit Card,174,4266,486,281
301,18,Male,Junior,Biology,737,490,5522,758,135,160,105,65,80,281,148,112,Cash,228,5627,295,177
302,25,Female,Freshman,Computer Science,1495,892,5525,767,182,97,213,135,30,196,54,21,Mobile Payment App,84,5738,279,156
303,20,Male,Senior,Economics,1298,971,5002,717,249,63,214,72,40,220,80,26,Mobile Payment App,120,5216,312,98
304,21,Male,Sophomore,Psychology,1272,784,3708,810,364,90,119,32,67,91,146,150,Credit/Debit Card,213,3827,454,182
305,19,Female,Senior,Biology,511,825,5383,917,201,152,117,147,42,244,75,126,Credit/Debit Card,117,5500,353,273
306,21,Female,Sophomore,Engineering,1161,566,5178,653,381,155,213,116,45,208,139,174,Credit/Debit Card,184,5391,536,290
307,21,Male,Senior,Psychology,1112,943,5832,881,292,93,288,135,82,67,102,157,Mobile Payment App,184,6120,385,292
308,25,Male,Junior,Economics,958,451,5949,655,163,78,96,150,54,78,76,176,Cash,130,6045,241,326
309,25,Non-binary,Junior,Engineering,1176,186,4044,615,319,93,108,46,96,184,61,37,Credit/Debit Card,157,4152,412,83
310,20,Non-binary,Senior,Engineering,727,451,3325,570,253,76,98,55,49,229,96,97,Cash,145,3423,329,152
311,25,Non-binary,Senior,Biology,1483,826,3048,733,136,103,278,114,22,282,110,60,Credit/Debit Card,132,3326,239,174
312,24,Male,Junior,Computer Science,881,97,4884,857,340,166,147,34,32,298,115,38,Credit/Debit Card,147,5031,506,72
313,21,Male,Freshman,Engineering,1347,634,5766,562,398,134,222,43,56,108,162,34,Mobile Payment App,218,5988,532,77
314,22,Female,Freshman,Psychology,725,132,4477,822,150,61,192,133,89,204,133,95,Mobile Payment App,222,4669,211,228
315,18,Non-binary,Sophomore,Biology,1000,270,4171,859,194,139,246,102,65,93,185,152,Credit/Debit Card,250,4417,333,254
316,24,Female,Sophomore,Engineering,795,580,4126,454,226,132,114,117,72,158,133,132,Credit/Debit Card,205,4240,358,249
317,18,Male,Senior,Economics,869,447,3962,416,369,112,71,44,51,160,74,43,Mobile Payment App,125,4033,481,87
318,24,Female,Freshman,Biology,543,177,4823,976,295,153,86,107,36,143,118,172,Credit/Debit Card,154,4909,448,279
319,25,Male,Sophomore,Economics,1470,403,5561,704,178,104,173,36,50,81,140,114,Credit/Debit Card,190,5734,282,150
320,19,Female,Freshman,Economics,734,838,4441,437,185,79,53,129,21,149,120,53,Cash,141,4494,264,182
321,20,Female,Freshman,Computer Science,669,638,5929,588,290,176,218,74,23,199,65,149,Mobile Payment App,88,6147,466,223
322,19,Female,Junior,Psychology,1336,417,4533,809,268,131,237,96,88,289,113,120,Cash,201,4770,399,216
323,21,Female,Sophomore,Economics,1436,435,5414,748,274,89,220,34,79,241,118,113,Mobile Payment App,197,5634,363,147
324,21,Non-binary,Freshman,Engineering,1339,777,5292,509,245,113,70,101,47,297,156,41,Mobile Payment App,203,5362,358,142
325,18,Female,Freshman,Biology,609,201,4477,930,260,178,272,98,83,138,129,52,Credit/Debit Card,212,4749,438,150
326,21,Non-binary,Sophomore,Economics,1036,169,4582,426,206,189,237,140,70,59,105,123,Mobile Payment App,175,4819,395,263
327,25,Female,Senior,Engineering,1309,840,5575,923,257,115,263,78,20,236,39,78,Mobile Payment App,59,5838,372,156
328,25,Male,Sophomore,Engineering,1471,521,4388,504,341,113,76,34,67,216,78,36,Cash,145,4464,454,70
329,19,Male,Freshman,Engineering,658,487,3579,705,292,172,198,20,50,209,68,21,Mobile Payment App,118,3777,464,41
330,19,Male,Junior,Engineering,684,728,5407,953,162,107,117,64,54,260,166,168,Mobile Payment App,220,5524,269,232
331,20,Male,Sophomore,Computer Science,907,468,3358,877,152,170,63,44,47,176,158,187,Credit/Debit Card,205,3421,322,231
332,18,Male,Freshman,Computer Science,846,671,4827,928,256,61,114,21,77,160,133,143,Mobile Payment App,210,4941,317,164
333,18,Female,Sophomore,Biology,1175,963,5461,498,218,81,182,26,60,296,143,24,Cash,203,5643,299,50
334,25,Male,Freshman,Biology,659,893,5837,867,142,77,163,105,79,184,166,140,Credit/Debit Card,245,6000,219,245
335,18,Non-binary,Sophomore,Economics,1488,492,5185,450,152,120,218,91,81,257,50,39,Cash,131,5403,272,130
336,22,Female,Senior,Psychology,1190,194,5107,483,299,179,173,30,68,144,170,119,Cash,238,5280,478,149
337,19,Female,Junior,Psychology,742,543,5288,772,125,162,123,126,51,94,113,71,Credit/Debit Card,164,5411,287,197
338,23,Non-binary,Freshman,Psychology,914,663,3265,809,175,60,125,21,81,135,194,154,Credit/Debit Card,275,3390,235,175
339,19,Male,Freshman,Biology,1485,53,3659,651,221,198,124,141,85,293,57,171,Cash,142,3783,419,312
340,20,Female,Junior,Biology,582,678,4190,722,112,188,97,133,66,69,131,147,Credit/Debit Card,197,4287,300,280
341,19,Non-binary,Junior,Engineering,1468,415,4764,613,115,157,121,31,88,77,56,117,Credit/Debit Card,144,4885,272,148
342,25,Female,Sophomore,Computer Science,1021,93,3755,512,104,188,146,103,63,183,128,34,Cash,191,3901,292,137
343,24,Male,Freshman,Computer Science,760,281,4727,822,394,88,191,50,48,160,188,81,Mobile Payment App,236,4918,482,131
344,24,Non-binary,Freshman,Economics,969,371,3771,889,336,59,298,35,89,201,74,75,Cash,163,4069,395,110
345,23,Female,Senior,Biology,990,431,3846,594,330,89,114,54,72,82,132,125,Mobile Payment App,204,3960,419,179
346,23,Non-binary,Sophomore,Engineering,1304,457,4240,878,111,165,86,123,41,120,124,27,Cash,165,4326,276,150
347,23,Male,Sophomore,Biology,805,0,4759,409,255,101,285,49,45,89,115,129,Credit/Debit Card,160,5044,356,178
348,25,Male,Senior,Engineering,1179,223,4058,952,340,118,65,121,51,174,41,177,Credit/Debit Card,92,4123,458,298
349,18,Non-binary,Senior,Computer Science,573,299,3003,878,229,131,157,58,88,53,182,190,Mobile Payment App,270,3160,360,248
350,25,Female,Senior,Psychology,843,4,4906,869,226,196,66,82,98,289,58,148,Mobile Payment App,156,4972,422,230
351,23,Non-binary,Junior,Biology,1085,795,3056,501,170,136,155,70,46,192,89,38,Mobile Payment App,135,3211,306,108
352,23,Female,Freshman,Biology,580,771,3789,707,322,170,244,114,75,79,188,107,Credit/Debit Card,263,4033,492,221
353,25,Female,Sophomore,Computer Science,975,630,4785,693,316,177,263,121,62,233,149,32,Cash,211,5048,493,153
354,23,Male,Senior,Psychology,602,608,4542,830,378,83,229,131,54,166,145,160,Credit/Debit Card,199,4771,461,291
355,23,Non-binary,Senior,Economics,1103,873,4761,671,394,121,215,112,47,118,119,115,Cash,166,4976,515,227
356,20,Non-binary,Freshman,Psychology,816,233,3909,949,136,165,53,59,30,275,183,32,Mobile Payment App,213,3962,301,91
357,24,Male,Freshman,Engineering,1016,201,5042,606,142,54,188,106,64,162,40,84,Cash,104,5230,196,190
358,23,Non-binary,Junior,Engineering,969,327,3449,516,312,182,186,25,44,186,117,164,Cash,161,3635,494,189
359,21,Non-binary,Junior,Computer Science,918,831,5934,949,391,81,127,121,64,275,141,159,Credit/Debit Card,205,6061,472,280
360,23,Non-binary,Senior,Computer Science,982,207,4397,710,159,118,89,109,87,225,65,69,Mobile Payment App,152,4486,277,178
361,25,Male,Junior,Computer Science,1021,912,5979,785,293,86,228,32,46,135,102,72,Cash,148,6207,379,104
362,22,Female,Sophomore,Psychology,521,884,5701,916,342,175,221,86,46,57,112,27,Mobile Payment App,158,5922,517,113
363,24,Female,Freshman,Computer Science,1444,881,3721,458,269,70,89,72,50,182,81,130,Mobile Payment App,131,3810,339,202
364,21,Male,Sophomore,Psychology,646,487,4218,822,124,74,108,52,97,68,105,48,Credit/Debit Card,202,4326,198,100
365,21,Female,Freshman,Economics,1296,133,3728,464,212,184,298,72,53,198,111,135,Mobile Payment App,164,4026,396,207
366,18,Non-binary,Freshman,Economics,1360,222,5759,810,164,153,77,60,99,180,177,143,Mobile Payment App,276,5836,317,203
367,19,Female,Senior,Biology,1123,5,5407,404,345,122,187,73,20,215,171,190,Cash,191,5594,467,263
368,18,Female,Senior,Psychology,1020,74,5837,552,123,138,267,98,63,267,163,30,Mobile Payment App,226,6104,261,128
369,21,Female,Freshman,Computer Science,736,628,3757,743,256,180,209,92,92,228,44,61,Credit/Debit Card,136,3966,436,153
370,23,Non-binary,Senior,Economics,931,322,5865,490,155,146,175,79,95,113,142,139,Cash,237,6040,301,218
371,24,Male,Senior,Psychology,1443,982,3807,814,364,169,299,126,20,102,193,127,Mobile Payment App,213,4106,533,253
372,22,Male,Freshman,Engineering,730,374,3483,675,230,68,212,124,72,156,118,181,Cash,190,3695,298,305
373,25,Non-binary,Senior,Economics,561,759,4229,781,147,88,144,55,95,114,142,56,Mobile Payment App,237,4373,235,111
374,25,Female,Sophomore,Economics,1212,616,5867,728,378,65,159,92,79,289,35,75,Cash,114,6026,443,167
375,25,Non-binary,Freshman,Computer Science,1282,416,5824,594,309,121,108,58,91,234,104,120,Cash,195,5932,430,178
376,21,Non-binary,Freshman,Biology,1438,364,5133,617,392,127,249,37,28,154,170,174,Mobile Payment App,198,5382,519,211
377,18,Female,Senior,Psychology,702,531,4901,497,237,150,298,46,62,225,123,130,Credit/Debit Card,185,5199,387,176
378,20,Male,Senior,Biology,1433,764,5002,589,397,51,288,135,100,71,48,112,Credit/Debit Card,148,5290,448,247
379,25,Female,Freshman,Psychology,1444,542,4680,829,207,122,260,109,37,127,43,69,Cash,80,4940,329,178
380,22,Female,Junior,Psychology,536,484,5803,413,326,104,86,99,69,197,167,157,Cash,236,5889,430,256
381,18,Non-binary,Freshman,Engineering,1260,68,3610,637,296,86,87,50,54,230,183,137,Credit/Debit Card,237,3697,382,187
382,18,Non-binary,Freshman,Biology,701,340,3235,969,337,65,152,113,99,169,161,159,Cash,260,3387,402,272
383,18,Female,Freshman,Engineering,1309,144,3419,728,171,116,152,107,85,124,76,78,Cash,161,3571,287,185
384,18,Non-binary,Sophomore,Economics,842,491,4582,473,202,156,279,120,81,270,67,78,Credit/Debit Card,148,4861,358,198
385,24,Male,Freshman,Computer Science,617,863,3795,837,231,152,256,41,74,221,130,106,Credit/Debit Card,204,4051,383,147
386,21,Non-binary,Junior,Engineering,1134,490,5864,714,370,96,199,114,82,67,190,24,Cash,272,6063,466,138
387,23,Non-binary,Sophomore,Psychology,992,242,4210,495,187,114,58,132,96,154,134,179,Mobile Payment App,230,4268,301,311
388,18,Non-binary,Freshman,Economics,1408,572,4271,477,320,78,150,150,81,163,46,24,Mobile Payment App,127,4421,398,174
389,21,Female,Senior,Biology,1368,940,3234,405,334,59,114,23,67,135,190,22,Mobile Payment App,257,3348,393,45
390,22,Male,Senior,Economics,716,157,4056,789,358,186,216,78,74,175,169,109,Cash,243,4272,544,187
391,22,Non-binary,Freshman,Psychology,1224,581,5309,936,264,55,188,126,47,194,79,26,Credit/Debit Card,126,5497,319,152
392,19,Non-binary,Senior,Biology,1349,788,4273,421,106,160,147,39,89,235,182,43,Cash,271,4420,266,82
393,24,Female,Sophomore,Engineering,802,552,3146,724,213,95,135,103,70,267,54,123,Cash,124,3281,308,226
394,18,Female,Senior,Psychology,973,318,3600,913,375,183,178,122,94,129,66,148,Cash,160,3778,558,270
395,19,Female,Senior,Engineering,736,660,5945,478,342,75,279,43,49,107,94,57,Mobile Payment App,143,6224,417,100
396,22,Male,Senior,Engineering,571,498,3897,648,181,56,275,86,57,287,79,110,Mobile Payment App,136,4172,237,196
397,25,Female,Sophomore,Engineering,833,56,3133,615,147,90,201,81,30,148,42,121,Cash,72,3334,237,202
398,22,Female,Freshman,Computer Science,713,382,4116,592,329,120,269,46,53,230,57,153,Credit/Debit Card,110,4385,449,199
399,20,Male,Junior,Economics,1268,475,5900,661,264,157,258,52,38,167,174,44,Cash,212,6158,421,96
400,19,Non-binary,Freshman,Biology,819,615,5075,858,153,200,115,76,90,139,154,44,Mobile Payment App,244,5190,353,120
401,18,Male,Senior,Economics,1268,324,3788,483,339,159,120,55,22,212,173,78,Credit/Debit Card,195,3908,498,133
402,18,Female,Senior,Engineering,1486,705,4043,661,178,64,276,80,69,144,115,26,Mobile Payment App,184,4319,242,106
403,24,Male,Freshman,Computer Science,1005,536,3944,687,262,148,200,138,53,146,194,80,Cash,247,4144,410,218
404,25,Female,Senior,Economics,1205,837,3014,593,183,142,112,77,59,209,145,78,Credit/Debit Card,204,3126,325,155
405,24,Male,Senior,Engineering,1356,858,5137,747,109,170,153,46,40,131,85,120,Mobile Payment App,125,5290,279,166
406,22,Male,Senior,Engineering,817,555,5754,716,382,135,142,21,29,188,183,41,Mobile Payment App,212,5896,517,62
407,22,Male,Sophomore,Biology,706,75,4080,874,139,183,93,41,47,136,164,109,Cash,211,4173,322,150
408,18,Non-binary,Junior,Economics,1102,490,5853,669,230,122,118,41,74,276,69,140,Cash,143,5971,352,181
409,22,Male,Sophomore,Engineering,1279,898,3980,471,265,148,77,68,37,132,192,157,Credit/Debit Card,229,4057,413,225
410,18,Male,Sophomore,Economics,1457,998,4232,957,375,139,167,141,31,196,35,55,Credit/Debit Card,66,4399,514,196
411,21,Female,Freshman,Psychology,1306,37,4943,569,326,100,277,91,85,246,48,79,Cash,133,5220,426,170
412,25,Male,Sophomore,Engineering,1309,433,4563,495,309,152,290,84,99,256,37,93,Credit/Debit Card,136,4853,461,177
413,19,Male,Freshman,Biology,1482,705,4973,433,294,144,233,149,59,167,130,96,Credit/Debit Card,189,5206,438,245
414,23,Male,Sophomore,Economics,1468,333,4845,563,107,74,129,119,24,123,98,173,Mobile Payment App,122,4974,181,292
415,25,Female,Sophomore,Economics,869,102,3556,544,387,161,158,48,80,163,93,129,Credit/Debit Card,173,3714,548,177
416,18,Male,Junior,Economics,886,917,5448,808,155,169,150,24,60,129,127,195,Mobile Payment App,187,5598,324,219
417,19,Female,Freshman,Economics,1443,831,4289,511,190,152,108,88,61,178,146,103,Mobile Payment App,207,4397,342,191
418,23,Non-binary,Freshman,Biology,766,95,4782,880,254,174,238,50,48,158,157,97,Cash,205,5020,428,147
419,22,Non-binary,Senior,Biology,1403,31,4595,761,331,179,57,97,67,273,179,56,Cash,246,4652,510,153
420,24,Non-binary,Freshman,Engineering,1372,803,4080,432,386,184,50,65,83,248,89,61,Credit/Debit Card,172,4130,570,126
421,23,Non-binary,Freshman,Biology,1428,597,5495,816,332,127,271,100,22,93,163,60,Mobile Payment App,185,5766,459,160
422,19,Male,Junior,Biology,1303,60,4515,511,387,179,244,68,100,261,35,154,Cash,135,4759,566,222
423,20,Non-binary,Sophomore,Economics,572,823,5879,438,360,72,118,80,45,265,48,30,Credit/Debit Card,93,5997,432,110
424,23,Non-binary,Junior,Economics,558,194,4648,865,183,60,113,128,38,265,42,167,Credit/Debit Card,80,4761,243,295
425,23,Female,Junior,Engineering,1049,476,5972,663,116,162,52,110,21,202,86,63,Mobile Payment App,107,6024,278,173
426,18,Female,Freshman,Computer Science,923,108,3640,409,384,117,249,76,68,152,86,128,Credit/Debit Card,154,3889,501,204
427,18,Female,Freshman,Engineering,621,35,5779,558,252,109,289,82,51,98,53,100,Cash,104,6068,361,182
428,21,Non-binary,Junior,Economics,660,348,5689,731,123,88,89,67,64,186,39,26,Mobile Payment App,103,5778,211,93
429,21,Non-binary,Freshman,Biology,528,92,3863,899,127,184,100,21,55,195,125,134,Mobile Payment App,180,3963,311,155
430,23,Female,Freshman,Psychology,640,618,3719,513,195,144,275,33,63,150,192,90,Mobile Payment App,255,3994,339,123
431,18,Female,Senior,Computer Science,1427,573,4307,797,224,161,136,87,59,159,87,20,Mobile Payment App,146,4443,385,107
432,18,Male,Sophomore,Computer Science,527,405,4577,532,133,134,292,62,50,164,33,127,Cash,83,4869,267,189
433,25,Female,Freshman,Psychology,1295,787,4591,764,358,142,190,121,77,244,75,113,Cash,152,4781,500,234
434,23,Female,Sophomore,Economics,1219,491,5149,551,168,126,184,41,67,203,83,35,Cash,150,5333,294,76
435,24,Female,Senior,Engineering,959,696,3200,593,318,188,153,150,89,285,54,102,Cash,143,3353,506,252
436,18,Non-binary,Sophomore,Biology,1483,995,3770,569,328,159,103,126,92,284,193,20,Credit/Debit Card,285,3873,487,146
437,19,Non-binary,Sophomore,Psychology,646,986,5700,857,309,77,88,66,98,174,126,153,Mobile Payment App,224,5788,386,219
438,23,Male,Senior,Biology,818,353,5174,662,222,160,194,28,98,193,177,166,Credit/Debit Card,275,5368,382,194
439,18,Male,Senior,Engineering,1268,598,3398,483,304,119,168,34,95,261,107,172,Credit/Debit Card,202,3566,423,206
440,22,Non-binary,Freshman,Biology,563,345,4713,953,249,181,128,54,54,273,40,122,Mobile Payment App,94,4841,430,176
441,21,Male,Freshman,Psychology,1253,464,5096,404,278,178,235,58,69,89,161,101,Credit/Debit Card,230,5331,456,159
442,18,Non-binary,Sophomore,Engineering,791,739,5601,628,269,116,102,55,58,179,66,136,Cash,124,5703,385,191
443,22,Non-binary,Sophomore,Psychology,847,964,3374,999,375,165,172,44,51,180,30,125,Cash,81,3546,540,169
444,24,Male,Junior,Economics,668,36,5962,635,280,166,176,112,83,191,115,41,Mobile Payment App,198,6138,446,153
445,24,Male,Freshman,Computer Science,1022,883,3174,832,121,137,142,54,65,93,47,170,Cash,112,3316,258,224
446,20,Non-binary,Senior,Economics,725,704,3181,440,363,85,219,24,73,189,190,33,Cash,263,3400,448,57
447,24,Non-binary,Junior,Biology,733,144,3556,427,214,71,212,136,73,296,157,157,Credit/Debit Card,230,3768,285,293
448,18,Non-binary,Freshman,Engineering,684,745,4569,884,322,140,265,20,99,201,132,164,Mobile Payment App,231,4834,462,184
449,20,Male,Senior,Psychology,604,494,3326,622,216,141,54,90,98,268,56,137,Mobile Payment App,154,3380,357,227
450,23,Male,Sophomore,Engineering,1346,83,5626,799,120,125,292,140,47,62,35,74,Mobile Payment App,82,5918,245,214
451,23,Non-binary,Junior,Biology,1464,750,3907,493,364,61,170,93,23,88,113,191,Credit/Debit Card,136,4077,425,284
452,18,Male,Sophomore,Psychology,1258,333,5189,537,370,195,195,84,57,126,125,71,Cash,182,5384,565,155
453,22,Male,Freshman,Economics,925,476,3755,718,227,80,173,70,88,185,35,43,Cash,123,3928,307,113
454,18,Male,Sophomore,Computer Science,927,880,5715,748,217,146,227,97,46,220,162,38,Mobile Payment App,208,5942,363,135
455,20,Non-binary,Freshman,Engineering,1230,967,3784,430,216,55,247,74,90,171,52,162,Mobile Payment App,142,4031,271,236
456,23,Non-binary,Freshman,Psychology,1437,777,5522,852,375,99,55,150,21,195,53,68,Credit/Debit Card,74,5577,474,218
457,21,Female,Sophomore,Computer Science,989,158,3913,919,377,159,152,115,40,299,58,176,Credit/Debit Card,98,4065,536,291
458,19,Male,Senior,Biology,910,724,5884,422,365,164,294,146,34,258,152,24,Cash,186,6178,529,170
459,18,Male,Freshman,Computer Science,1323,441,3373,701,369,60,235,44,78,276,38,139,Cash,116,3608,429,183
460,20,Female,Sophomore,Engineering,668,33,4067,453,243,84,283,132,72,294,50,99,Mobile Payment App,122,4350,327,231
461,25,Female,Senior,Biology,1004,465,5665,835,126,179,297,23,52,238,79,104,Credit/Debit Card,131,5962,305,127
462,21,Female,Junior,Economics,1415,561,3083,967,347,114,175,100,30,166,162,120,Credit/Debit Card,192,3258,461,220
463,18,Male,Freshman,Engineering,948,739,3799,812,344,111,205,139,94,249,107,43,Credit/Debit Card,201,4004,455,182
464,21,Non-binary,Junior,Biology,1010,248,3146,972,356,170,60,67,54,77,124,100,Mobile Payment App,178,3206,526,167
465,19,Female,Sophomore,Biology,873,549,3887,423,111,120,166,116,68,255,137,30,Credit/Debit Card,205,4053,231,146
466,19,Female,Sophomore,Computer Science,921,148,4073,677,212,78,173,52,33,141,161,69,Cash,194,4246,290,121
467,19,Female,Freshman,Engineering,1459,285,4511,619,299,145,295,96,71,95,35,170,Mobile Payment App,106,4806,444,266
468,25,Male,Freshman,Biology,672,213,3980,420,362,64,290,131,53,201,102,83,Credit/Debit Card,155,4270,426,214
469,23,Non-binary,Senior,Engineering,1461,299,4335,500,120,65,112,83,41,83,54,107,Mobile Payment App,95,4447,185,190
470,24,Male,Senior,Psychology,1492,644,4495,468,234,76,205,58,80,159,157,66,Credit/Debit Card,237,4700,310,124
471,19,Male,Senior,Computer Science,627,995,5863,937,188,177,155,137,97,117,172,180,Cash,269,6018,365,317
472,23,Male,Freshman,Computer Science,961,87,5819,781,393,56,155,64,86,146,63,48,Mobile Payment App,149,5974,449,112
473,22,Male,Senior,Engineering,954,134,3455,664,332,183,227,36,69,180,45,68,Credit/Debit Card,114,3682,515,104
474,20,Non-binary,Junior,Biology,1486,958,5843,757,119,135,72,114,47,82,93,136,Mobile Payment App,140,5915,254,250
475,24,Female,Freshman,Psychology,1331,681,5918,949,335,125,258,94,94,171,34,127,Mobile Payment App,128,6176,460,221
476,21,Female,Senior,Computer Science,551,492,3257,930,335,59,61,41,60,59,146,151,Cash,206,3318,394,192
477,18,Non-binary,Senior,Biology,1352,475,5868,718,264,196,151,114,26,244,65,57,Credit/Debit Card,91,6019,460,171
478,22,Female,Senior,Engineering,1437,204,3820,497,319,161,217,23,81,67,125,149,Mobile Payment App,206,4037,480,172
479,25,Non-binary,Sophomore,Biology,1146,504,4965,707,295,127,114,97,30,141,63,24,Mobile Payment App,93,5079,422,121
480,21,Male,Freshman,Biology,1341,899,3133,850,364,183,262,129,26,188,94,130,Credit/Debit Card,120,3395,547,259
481,25,Female,Sophomore,Biology,1331,227,5479,750,155,184,88,87,72,87,157,53,Mobile Payment App,229,5567,339,140
482,25,Male,Freshman,Computer Science,1195,845,3900,624,258,183,178,122,91,271,53,94,Mobile Payment App,144,4078,441,216
483,24,Non-binary,Sophomore,Psychology,1247,269,5692,638,158,196,190,92,88,174,100,68,Cash,188,5882,354,160
484,25,Female,Senior,Biology,663,798,5418,420,389,97,282,144,84,149,123,167,Cash,207,5700,486,311
485,23,Female,Senior,Engineering,861,776,4227,924,143,190,208,114,82,119,172,71,Credit/Debit Card,254,4435,333,185
486,23,Male,Senior,Economics,568,340,3025,620,300,92,233,75,52,296,191,109,Credit/Debit Card,243,3258,392,184
487,20,Female,Senior,Psychology,802,254,4626,568,179,64,265,124,51,117,158,123,Credit/Debit Card,209,4891,243,247
488,24,Male,Freshman,Economics,821,414,5858,719,174,133,52,76,65,142,66,39,Cash,131,5910,307,115
489,19,Female,Freshman,Computer Science,1009,770,4354,511,300,189,156,150,54,270,146,46,Credit/Debit Card,200,4510,489,196
490,19,Non-binary,Junior,Computer Science,526,633,3093,940,215,109,54,31,80,193,192,42,Mobile Payment App,272,3147,324,73
491,22,Female,Junior,Computer Science,502,755,3717,473,153,54,53,92,50,290,144,70,Mobile Payment App,194,3770,207,162
492,19,Non-binary,Freshman,Biology,860,550,5703,503,203,171,117,29,31,87,82,196,Mobile Payment App,113,5820,374,225
493,18,Non-binary,Junior,Economics,1420,576,5141,835,168,102,277,57,47,260,86,196,Cash,133,5418,270,253
494,21,Female,Senior,Computer Science,540,931,4582,651,221,135,100,21,39,75,72,183,Mobile Payment App,111,4682,356,204
495,25,Non-binary,Freshman,Psychology,737,995,4234,562,288,62,293,103,89,281,31,162,Mobile Payment App,120,4527,350,265
496,22,Non-binary,Freshman,Psychology,503,57,3138,843,276,177,175,37,26,258,105,165,Cash,131,3313,453,202
497,22,Female,Freshman,Computer Science,673,972,5357,828,279,95,298,97,21,154,34,162,Mobile Payment App,55,5655,374,259
498,25,Female,Freshman,Psychology,681,115,5355,848,209,118,51,112,83,240,188,172,Cash,271,5406,327,284
499,22,Male,Freshman,Computer Science,1356,766,5387,599,347,200,238,77,65,190,72,196,Mobile Payment App,137,5625,547,273
500,25,Female,Sophomore,Computer Science,1062,390,3394,946,298,117,191,116,36,102,73,159,Credit/Debit Card,109,3585,415,275
501,18,Male,Sophomore,Economics,1399,653,3413,703,157,182,67,41,81,108,154,28,Cash,235,3480,339,69
502,19,Female,Junior,Engineering,1402,705,3268,715,305,134,87,100,100,228,103,144,Cash,203,3355,439,244
503,24,Non-binary,Sophomore,Engineering,1184,260,5610,490,376,168,183,102,73,183,85,123,Cash,158,5793,544,225
504,21,Male,Senior,Economics,743,351,3735,746,305,51,201,55,74,284,117,91,Cash,191,3936,356,146
505,25,Male,Sophomore,Biology,1384,490,3253,462,286,158,240,90,24,296,191,115,Mobile Payment App,215,3493,444,205
506,20,Male,Junior,Biology,997,641,4000,589,167,130,142,24,70,179,130,57,Credit/Debit Card,200,4142,297,81
507,24,Male,Senior,Engineering,618,109,4178,626,335,118,184,22,75,139,85,65,Credit/Debit Card,160,4362,453,87
508,25,Female,Junior,Psychology,1320,498,5329,559,236,122,262,95,61,164,108,65,Cash,169,5591,358,160
509,25,Male,Sophomore,Computer Science,959,522,4611,402,369,67,162,106,24,141,45,87,Cash,69,4773,436,193
510,20,Non-binary,Junior,Psychology,950,656,4369,916,207,97,90,42,78,284,75,48,Mobile Payment App,153,4459,304,90
511,24,Non-binary,Senior,Economics,1286,456,5916,973,263,60,108,115,22,116,63,168,Credit/Debit Card,85,6024,323,283
512,19,Non-binary,Freshman,Computer Science,893,312,4417,981,156,141,240,125,59,161,118,26,Cash,177,4657,297,151
513,18,Female,Freshman,Psychology,1126,891,4242,624,182,100,136,86,66,243,83,30,Cash,149,4378,282,116
514,22,Male,Sophomore,Biology,679,481,5466,674,180,152,147,133,58,67,130,159,Mobile Payment App,188,5613,332,292
515,25,Male,Freshman,Psychology,803,201,5914,859,143,173,143,142,96,170,103,30,Credit/Debit Card,199,6057,316,172
516,18,Female,Senior,Biology,664,115,3692,963,213,70,230,150,74,199,167,113,Credit/Debit Card,241,3922,283,263
517,18,Male,Senior,Computer Science,1500,777,5326,772,298,182,173,112,66,170,41,103,Cash,107,5499,480,215
518,22,Male,Junior,Psychology,1005,777,5596,865,158,56,113,102,71,249,148,196,Credit/Debit Card,219,5709,214,298
519,22,Female,Sophomore,Biology,883,640,5515,751,243,168,240,138,20,102,55,93,Credit/Debit Card,75,5755,411,231
520,18,Non-binary,Freshman,Biology,1428,327,5183,822,118,184,209,27,50,212,89,129,Cash,139,5392,302,156
521,21,Non-binary,Sophomore,Economics,906,449,3883,713,338,126,300,86,46,55,64,122,Cash,110,4183,464,208
522,18,Non-binary,Freshman,Computer Science,991,836,3317,518,315,98,82,139,94,130,145,151,Cash,239,3399,413,290
523,23,Female,Freshman,Engineering,1246,754,5420,504,372,107,222,104,31,163,116,182,Mobile Payment App,147,5642,479,286
524,22,Female,Freshman,Biology,1273,10,4229,887,168,197,134,140,60,236,95,136,Credit/Debit Card,155,4363,365,276
525,22,Male,Junior,Psychology,880,184,4706,415,105,182,266,58,68,277,176,36,Credit/Debit Card,244,4972,287,94
526,24,Non-binary,Junior,Computer Science,1356,328,5658,901,369,156,284,114,76,145,119,102,Credit/Debit Card,195,5942,525,216
527,23,Female,Junior,Economics,916,927,5244,411,249,157,173,69,71,255,83,189,Credit/Debit Card,154,5417,406,258
528,18,Non-binary,Freshman,Economics,1059,668,3940,836,175,131,168,30,81,215,178,31,Credit/Debit Card,259,4108,306,61
529,24,Female,Junior,Psychology,941,203,3048,617,214,113,233,109,49,266,73,176,Credit/Debit Card,122,3281,327,285
530,24,Male,Senior,Psychology,764,521,4504,828,142,117,163,73,32,299,51,51,Mobile Payment App,83,4667,259,124
531,25,Non-binary,Sophomore,Economics,983,670,4654,613,246,126,255,146,20,59,155,197,Cash,175,4909,372,343
532,18,Non-binary,Senior,Biology,1295,263,4502,647,112,137,172,106,88,108,42,32,Mobile Payment App,130,4674,249,138
533,22,Female,Sophomore,Computer Science,1301,883,4856,519,141,57,99,76,70,60,116,199,Cash,186,4955,198,275
534,22,Non-binary,Junior,Biology,829,369,5246,702,146,88,286,144,37,268,85,191,Cash,122,5532,234,335
535,22,Non-binary,Sophomore,Psychology,1296,1,4574,759,147,143,56,128,72,202,49,190,Credit/Debit Card,121,4630,290,318
536,21,Male,Freshman,Biology,1278,506,3566,513,360,81,145,48,70,252,94,140,Credit/Debit Card,164,3711,441,188
537,18,Female,Senior,Biology,725,148,4782,643,169,164,59,137,76,207,189,42,Credit/Debit Card,265,4841,333,179
538,20,Male,Senior,Biology,525,41,4603,889,187,85,118,24,85,75,158,108,Cash,243,4721,272,132
539,25,Non-binary,Junior,Biology,1006,293,3397,583,167,74,195,22,75,77,174,107,Mobile Payment App,249,3592,241,129
540,20,Male,Sophomore,Biology,872,661,5328,470,220,167,249,122,47,152,51,128,Mobile Payment App,98,5577,387,250
541,20,Non-binary,Senior,Engineering,549,302,5909,409,270,66,117,61,75,278,132,30,Credit/Debit Card,207,6026,336,91
542,20,Non-binary,Junior,Engineering,885,380,5717,726,135,60,60,69,27,127,87,179,Cash,114,5777,195,248
543,19,Female,Senior,Computer Science,1197,772,4227,695,180,91,104,106,31,177,48,21,Mobile Payment App,79,4331,271,127
544,25,Male,Senior,Psychology,539,429,5598,869,209,71,106,116,41,120,149,36,Cash,190,5704,280,152
545,22,Male,Sophomore,Computer Science,804,911,3810,577,291,167,294,64,64,266,134,137,Cash,198,4104,458,201
546,25,Non-binary,Sophomore,Economics,1109,289,3324,946,359,123,272,88,27,141,107,125,Mobile Payment App,134,3596,482,213
547,25,Female,Senior,Computer Science,1126,771,3126,823,374,125,215,90,77,242,112,99,Credit/Debit Card,189,3341,499,189
548,22,Non-binary,Junior,Economics,849,229,5145,830,364,113,118,60,35,237,175,192,Cash,210,5263,477,252
549,23,Non-binary,Sophomore,Psychology,503,158,4627,696,361,121,136,141,60,95,139,72,Credit/Debit Card,199,4763,482,213
550,20,Male,Senior,Biology,1293,449,3734,913,324,149,134,103,86,288,131,120,Mobile Payment App,217,3868,473,223
551,20,Male,Junior,Biology,903,96,4215,502,294,77,160,96,23,87,161,73,Credit/Debit Card,184,4375,371,169
552,23,Non-binary,Junior,Psychology,1149,685,5510,503,308,171,206,144,82,109,196,60,Credit/Debit Card,278,5716,479,204
553,20,Non-binary,Freshman,Biology,1363,536,3639,536,132,137,231,107,91,208,185,72,Mobile Payment App,276,3870,269,179
554,19,Non-binary,Junior,Engineering,1056,959,4665,593,100,157,214,113,50,286,87,200,Cash,137,4879,257,313
555,18,Male,Senior,Engineering,1245,80,3063,836,397,136,89,110,29,155,59,186,Mobile Payment App,88,3152,533,296
556,25,Female,Senior,Computer Science,1149,387,5744,849,301,112,162,141,74,89,107,108,Mobile Payment App,181,5906,413,249
557,19,Female,Freshman,Psychology,1226,798,4066,494,350,192,159,34,52,226,136,62,Cash,188,4225,542,96
558,22,Non-binary,Freshman,Engineering,965,387,3983,466,205,191,116,65,61,192,96,188,Mobile Payment App,157,4099,396,253
559,21,Male,Freshman,Engineering,1338,889,4956,658,179,79,151,116,30,116,191,24,Credit/Debit Card,221,5107,258,140
560,20,Male,Senior,Engineering,1414,811,5141,752,186,139,170,64,46,148,31,96,Credit/Debit Card,77,5311,325,160
561,24,Non-binary,Junior,Psychology,1232,648,5249,485,248,52,64,94,75,280,48,46,Mobile Payment App,123,5313,300,140
562,18,Male,Freshman,Engineering,528,612,4015,477,286,87,93,29,76,292,175,65,Cash,251,4108,373,94
563,22,Male,Sophomore,Computer Science,1377,500,4846,482,335,133,87,33,57,161,82,98,Credit/Debit Card,139,4933,468,131
564,23,Non-binary,Freshman,Computer Science,1078,857,4983,887,248,152,211,52,24,180,106,130,Credit/Debit Card,130,5194,400,182
565,20,Male,Sophomore,Computer Science,766,926,5019,898,226,60,174,86,22,188,147,111,Cash,169,5193,286,197
566,22,Non-binary,Senior,Engineering,1289,253,4960,529,229,59,182,35,64,96,123,77,Credit/Debit Card,187,5142,288,112
567,21,Male,Sophomore,Economics,887,825,4948,731,309,194,60,109,86,126,177,140,Cash,263,5008,503,249
568,18,Male,Sophomore,Biology,1040,721,3004,919,206,81,197,48,60,159,132,70,Cash,192,3201,287,118
569,21,Female,Senior,Engineering,940,973,5912,951,352,108,62,62,70,249,98,150,Credit/Debit Card,168,5974,460,212
570,25,Male,Sophomore,Biology,895,924,5734,489,157,94,92,21,23,261,57,113,Mobile Payment App,80,5826,251,134
571,25,Male,Sophomore,Psychology,1113,378,3901,533,201,133,156,146,61,144,81,87,Credit/Debit Card,142,4057,334,233
572,24,Non-binary,Freshman,Biology,982,563,5027,830,264,126,213,52,62,296,157,54,Cash,219,5240,390,106
573,22,Male,Freshman,Psychology,1401,392,5008,769,331,149,280,38,33,100,150,167,Credit/Debit Card,183,5288,480,205
574,18,Male,Sophomore,Psychology,772,72,5891,765,359,133,51,23,61,250,128,171,Mobile Payment App,189,5942,492,194
575,20,Male,Senior,Economics,912,387,3866,487,261,199,225,115,34,184,197,144,Credit/Debit Card,231,4091,460,259
576,23,Female,Sophomore,Economics,946,859,5240,409,380,179,148,81,59,101,139,96,Cash,198,5388,559,177
577,23,Non-binary,Junior,Biology,834,858,4874,565,127,102,216,119,93,143,144,82,Mobile Payment App,237,5090,229,201
578,24,Male,Freshman,Psychology,695,457,3265,438,340,77,109,63,24,201,137,82,Cash,161,3374,417,145
579,20,Male,Sophomore,Biology,1479,398,5517,854,238,93,254,118,22,143,36,67,Cash,58,5771,331,185
580,21,Non-binary,Sophomore,Economics,994,469,3783,415,144,172,133,41,88,284,116,199,Mobile Payment App,204,3916,316,240
581,25,Female,Sophomore,Biology,843,555,5071,604,126,195,193,107,53,159,49,72,Mobile Payment App,102,5264,321,179
582,21,Non-binary,Junior,Biology,1412,671,6000,917,295,191,103,22,85,297,62,140,Mobile Payment App,147,6103,486,162
583,22,Male,Junior,Computer Science,727,238,5354,733,325,182,155,42,81,220,199,176,Credit/Debit Card,280,5509,507,218
584,25,Male,Sophomore,Computer Science,622,642,4637,862,290,200,266,21,44,229,168,77,Mobile Payment App,212,4903,490,98
585,23,Female,Senior,Computer Science,1392,197,3161,954,287,101,168,55,52,180,135,99,Credit/Debit Card,187,3329,388,154
586,19,Male,Sophomore,Computer Science,1491,809,4924,792,191,144,287,81,36,223,104,186,Credit/Debit Card,140,5211,335,267
587,22,Non-binary,Junior,Engineering,1038,540,4378,791,202,93,184,105,48,254,79,160,Mobile Payment App,127,4562,295,265
588,24,Female,Junior,Biology,854,501,3269,990,249,198,247,135,27,53,98,67,Mobile Payment App,125,3516,447,202
589,21,Male,Sophomore,Biology,1415,688,5211,857,254,156,275,148,54,227,119,87,Cash,173,5486,410,235
590,18,Non-binary,Senior,Economics,1136,434,4522,642,144,121,219,149,80,188,54,146,Mobile Payment App,134,4741,265,295
591,22,Non-binary,Senior,Computer Science,971,100,3645,979,163,134,50,85,86,267,193,80,Credit/Debit Card,279,3695,297,165
592,20,Non-binary,Senior,Economics,1115,31,5206,442,332,149,229,116,69,272,103,160,Mobile Payment App,172,5435,481,276
593,20,Non-binary,Freshman,Biology,523,279,4777,417,256,188,156,105,77,191,137,41,Cash,214,4933,444,146
594,24,Non-binary,Junior,Psychology,533,815,5620,850,203,166,220,91,34,235,39,138,Credit/Debit Card,73,5840,369,229
595,19,Female,Sophomore,Psychology,1129,832,3885,691,131,147,218,38,38,292,168,100,Cash,206,4103,278,138
596,22,Non-binary,Senior,Economics,739,883,3099,900,281,111,108,121,29,161,137,46,Credit/Debit Card,166,3207,392,167
597,18,Female,Senior,Engineering,1099,423,3690,973,287,98,270,146,100,136,128,129,Mobile Payment App,228,3960,385,275
598,25,Non-binary,Junior,Psychology,610,148,5414,887,256,57,209,84,76,220,184,104,Mobile Payment App,260,5623,313,188
599,23,Male,Junior,Biology,1305,642,5566,844,274,120,178,28,28,179,122,73,Credit/Debit Card,150,5744,394,101
600,23,Female,Freshman,Engineering,1263,744,3369,825,141,117,135,45,39,159,158,114,Cash,197,3504,258,159
601,23,Female,Freshman,Engineering,656,836,3586,770,172,111,261,78,99,177,145,74,Cash,244,3847,283,152
602,22,Female,Junior,Economics,975,406,3855,752,249,93,122,125,56,181,103,50,Credit/Debit Card,159,3977,342,175
603,25,Male,Freshman,Computer Science,1459,996,4957,892,142,51,243,128,83,131,64,35,Mobile Payment App,147,5200,193,163
604,25,Non-binary,Junior,Biology,1302,115,3265,561,252,88,196,84,27,158,125,121,Mobile Payment App,152,3461,340,205
605,18,Female,Senior,Computer Science,1115,709,4745,733,262,118,197,97,79,182,32,52,Mobile Payment App,111,4942,380,149
606,24,Non-binary,Freshman,Engineering,816,658,4614,498,181,103,54,67,68,288,163,141,Mobile Payment App,231,4668,284,208
607,24,Non-binary,Freshman,Engineering,1358,32,5658,696,136,77,216,70,89,103,90,163,Mobile Payment App,179,5874,213,233
608,20,Female,Junior,Psychology,1054,87,5634,998,266,170,191,137,100,175,94,81,Cash,194,5825,436,218
609,24,Non-binary,Freshman,Engineering,1372,208,4545,669,262,76,211,138,83,291,73,109,Credit/Debit Card,156,4756,338,247
610,24,Non-binary,Sophomore,Engineering,1101,508,3718,423,341,155,291,111,75,263,122,52,Mobile Payment App,197,4009,496,163
611,23,Male,Junior,Engineering,1258,939,4662,745,250,121,238,101,60,263,34,113,Cash,94,4900,371,214
612,23,Male,Freshman,Biology,1399,663,4775,612,289,169,116,148,74,239,199,82,Cash,273,4891,458,230
613,21,Male,Senior,Biology,1469,592,5685,505,272,56,239,23,57,161,107,183,Cash,164,5924,328,206
614,23,Male,Sophomore,Engineering,560,300,4954,554,100,122,174,109,92,188,68,115,Cash,160,5128,222,224
615,24,Male,Freshman,Engineering,527,337,5328,462,349,171,288,145,92,241,120,125,Credit/Debit Card,212,5616,520,270
616,20,Male,Freshman,Biology,1165,282,3264,869,132,91,255,56,37,85,187,61,Mobile Payment App,224,3519,223,117
617,25,Male,Junior,Computer Science,996,692,4653,765,351,148,243,31,58,74,191,176,Credit/Debit Card,249,4896,499,207
618,24,Male,Junior,Engineering,630,528,4001,921,377,193,87,142,60,155,51,58,Cash,111,4088,570,200
619,19,Male,Junior,Engineering,542,205,4638,838,332,67,237,74,80,205,116,175,Mobile Payment App,196,4875,399,249
620,19,Non-binary,Freshman,Psychology,648,929,4294,696,267,104,215,79,96,286,35,44,Credit/Debit Card,131,4509,371,123
621,22,Non-binary,Senior,Computer Science,639,699,4625,463,338,80,265,51,80,295,103,137,Credit/Debit Card,183,4890,418,188
622,18,Non-binary,Sophomore,Engineering,729,665,4464,670,378,122,191,145,94,198,169,101,Cash,263,4655,500,246
623,19,Male,Junior,Computer Science,1021,473,4614,875,282,57,191,42,40,153,106,157,Mobile Payment App,146,4805,339,199
624,23,Male,Senior,Economics,1229,794,4968,953,216,85,85,143,37,280,94,185,Credit/Debit Card,131,5053,301,328
625,21,Male,Junior,Engineering,660,207,5365,547,194,59,112,98,23,229,168,64,Credit/Debit Card,191,5477,253,162
626,21,Non-binary,Freshman,Computer Science,1343,6,3103,759,238,75,289,107,41,170,89,44,Cash,130,3392,313,151
627,25,Non-binary,Junior,Computer Science,833,410,4562,525,330,50,245,112,89,132,137,155,Cash,226,4807,380,267
628,22,Male,Freshman,Computer Science,555,51,5060,534,354,69,64,33,48,76,42,26,Cash,90,5124,423,59
629,22,Male,Freshman,Engineering,541,94,5373,409,264,79,288,59,43,113,175,33,Credit/Debit Card,218,5661,343,92
630,22,Non-binary,Senior,Economics,748,296,3962,721,389,71,108,89,93,106,186,170,Credit/Debit Card,279,4070,460,259
631,21,Female,Sophomore,Engineering,1477,497,4287,851,296,53,95,134,61,143,87,134,Cash,148,4382,349,268
632,22,Non-binary,Senior,Biology,1236,189,5655,773,175,145,256,122,60,143,118,169,Credit/Debit Card,178,5911,320,291
633,25,Male,Freshman,Biology,592,657,3801,939,137,127,280,59,75,265,70,85,Cash,145,4081,264,144
634,25,Female,Senior,Computer Science,558,830,4642,895,349,89,273,45,83,79,122,143,Mobile Payment App,205,4915,438,188
635,23,Male,Sophomore,Engineering,925,414,4123,776,178,106,268,105,39,201,144,108,Credit/Debit Card,183,4391,284,213
636,18,Male,Senior,Computer Science,719,498,3780,494,312,149,111,126,73,60,57,169,Mobile Payment App,130,3891,461,295
637,24,Female,Junior,Engineering,981,875,3266,852,201,167,102,118,72,124,62,110,Credit/Debit Card,134,3368,368,228
638,25,Non-binary,Senior,Economics,1381,882,3704,464,269,88,257,105,47,106,135,66,Credit/Debit Card,182,3961,357,171
639,18,Non-binary,Sophomore,Biology,929,126,3357,615,324,73,162,150,58,211,87,77,Cash,145,3519,397,227
640,24,Male,Junior,Biology,1245,906,5452,459,255,128,95,44,47,288,195,191,Mobile Payment App,242,5547,383,235
641,20,Female,Junior,Economics,691,340,3798,748,152,53,262,118,91,112,163,71,Mobile Payment App,254,4060,205,189
642,24,Female,Freshman,Psychology,1326,499,5353,852,129,166,183,91,85,291,54,141,Credit/Debit Card,139,5536,295,232
643,18,Non-binary,Junior,Psychology,1000,203,5199,559,371,104,144,70,63,102,95,105,Credit/Debit Card,158,5343,475,175
644,25,Male,Junior,Computer Science,592,662,5221,694,119,93,275,92,58,52,180,160,Credit/Debit Card,238,5496,212,252
645,22,Male,Senior,Economics,1227,226,3658,951,218,199,238,73,79,112,196,67,Mobile Payment App,275,3896,417,140
646,20,Female,Sophomore,Engineering,575,534,5231,506,378,66,141,66,75,56,153,99,Cash,228,5372,444,165
647,19,Female,Junior,Engineering,1298,323,3510,444,222,168,221,98,61,175,133,69,Credit/Debit Card,194,3731,390,167
648,23,Male,Sophomore,Engineering,1141,482,3621,572,121,184,108,41,55,93,126,86,Cash,181,3729,305,127
649,25,Male,Senior,Biology,703,654,5926,735,295,100,278,39,80,139,178,190,Credit/Debit Card,258,6204,395,229
650,23,Female,Freshman,Economics,929,160,3445,418,213,83,159,87,54,55,198,135,Mobile Payment App,252,3604,296,222
651,23,Non-binary,Junior,Engineering,1415,970,3694,513,148,157,297,104,42,294,154,161,Mobile Payment App,196,3991,305,265
652,18,Non-binary,Senior,Engineering,1359,387,5747,995,263,193,246,32,23,152,110,120,Credit/Debit Card,133,5993,456,152
653,23,Male,Freshman,Biology,1162,720,5880,630,259,117,113,127,94,126,89,130,Cash,183,5993,376,257
654,18,Female,Sophomore,Biology,663,304,5655,632,176,89,215,57,61,51,56,107,Credit/Debit Card,117,5870,265,164
655,18,Non-binary,Freshman,Economics,1432,9,5568,929,224,108,265,69,22,102,120,151,Credit/Debit Card,142,5833,332,220
656,20,Non-binary,Freshman,Computer Science,663,823,3637,695,191,147,277,23,73,212,188,179,Mobile Payment App,261,3914,338,202
657,18,Non-binary,Senior,Economics,1327,109,3975,940,363,153,157,88,98,119,52,20,Credit/Debit Card,150,4132,516,108
658,22,Male,Senior,Psychology,1045,359,5381,610,269,71,209,49,83,291,168,183,Credit/Debit Card,251,5590,340,232
659,21,Male,Junior,Computer Science,619,605,3238,793,380,89,87,135,36,209,92,84,Credit/Debit Card,128,3325,469,219
660,21,Non-binary,Freshman,Economics,815,905,3053,433,355,84,241,89,67,262,141,41,Cash,208,3294,439,130
661,20,Non-binary,Freshman,Biology,728,399,5128,967,152,139,293,96,39,287,184,157,Cash,223,5421,291,253
662,21,Male,Senior,Economics,941,831,3687,722,390,135,81,131,69,124,107,38,Mobile Payment App,176,3768,525,169
663,18,Male,Freshman,Psychology,1176,43,3352,838,211,60,278,121,21,108,87,164,Credit/Debit Card,108,3630,271,285
664,22,Non-binary,Sophomore,Computer Science,1092,574,3997,731,187,93,151,63,55,96,169,118,Credit/Debit Card,224,4148,280,181
665,18,Female,Sophomore,Biology,1439,526,3394,896,176,86,134,63,52,150,175,129,Mobile Payment App,227,3528,262,192
666,22,Male,Senior,Economics,816,616,3461,543,350,101,90,103,24,245,44,150,Credit/Debit Card,68,3551,451,253
667,18,Male,Junior,Biology,1413,775,4715,457,264,71,250,127,54,152,91,120,Cash,145,4965,335,247
668,24,Female,Sophomore,Biology,1076,355,4596,464,134,99,167,97,34,77,51,149,Cash,85,4763,233,246
669,21,Female,Sophomore,Economics,559,169,5303,431,222,103,237,80,56,188,78,176,Credit/Debit Card,134,5540,325,256
670,23,Male,Sophomore,Engineering,1144,800,3881,405,381,130,179,106,94,216,82,50,Credit/Debit Card,176,4060,511,156
671,20,Non-binary,Junior,Psychology,1296,113,5452,462,191,69,238,93,51,155,187,102,Credit/Debit Card,238,5690,260,195
672,24,Male,Senior,Engineering,958,902,4579,425,262,156,72,137,21,282,82,135,Cash,103,4651,418,272
673,25,Male,Junior,Economics,775,709,4195,680,115,182,84,128,26,106,112,93,Credit/Debit Card,138,4279,297,221
674,25,Non-binary,Junior,Economics,1483,519,4676,970,145,168,270,23,39,72,106,186,Mobile Payment App,145,4946,313,209
675,19,Male,Junior,Biology,1304,232,4540,651,184,102,191,148,67,268,45,50,Mobile Payment App,112,4731,286,198
676,24,Female,Sophomore,Biology,1400,892,4726,749,359,163,294,132,20,208,148,82,Mobile Payment App,168,5020,522,214
677,24,Non-binary,Freshman,Computer Science,1440,869,5852,759,271,75,187,77,66,295,196,71,Mobile Payment App,262,6039,346,148
678,22,Female,Freshman,Economics,1460,650,3562,771,311,62,265,53,96,112,37,77,Credit/Debit Card,133,3827,373,130
679,20,Non-binary,Junior,Biology,1379,714,4758,927,192,119,288,137,59,95,194,33,Credit/Debit Card,253,5046,311,170
680,18,Female,Junior,Computer Science,942,545,5805,914,108,50,206,24,56,54,188,70,Mobile Payment App,244,6011,158,94
681,25,Non-binary,Junior,Biology,740,871,4194,473,366,83,156,62,33,86,81,78,Cash,114,4350,449,140
682,18,Female,Sophomore,Psychology,1186,733,5923,541,291,111,114,42,49,73,166,131,Cash,215,6037,402,173
683,23,Male,Junior,Biology,731,812,5637,582,148,74,234,27,68,158,81,48,Cash,149,5871,222,75
684,20,Male,Junior,Economics,1347,735,5563,974,310,98,167,35,43,298,182,37,Cash,225,5730,408,72
685,19,Female,Freshman,Biology,1085,417,4680,705,159,182,295,132,66,105,185,54,Cash,251,4975,341,186
686,22,Male,Senior,Biology,665,401,3645,967,151,50,232,118,75,182,181,148,Mobile Payment App,256,3877,201,266
687,22,Male,Freshman,Economics,1422,674,5030,663,332,148,251,130,61,187,124,117,Cash,185,5281,480,247
688,24,Male,Freshman,Biology,1366,319,3549,921,389,127,146,44,93,224,151,30,Mobile Payment App,244,3695,516,74
689,21,Female,Sophomore,Engineering,714,645,3751,853,149,66,184,35,21,219,176,72,Mobile Payment App,197,3935,215,107
690,25,Male,Freshman,Psychology,1259,139,4943,747,200,94,226,142,39,140,95,65,Credit/Debit Card,134,5169,294,207
691,19,Female,Senior,Economics,975,939,3256,936,368,179,165,144,89,52,48,120,Mobile Payment App,137,3421,547,264
692,24,Female,Senior,Engineering,1420,235,3609,841,151,190,175,20,97,57,154,71,Cash,251,3784,341,91
693,24,Non-binary,Sophomore,Engineering,604,751,3687,554,217,66,188,122,32,169,69,150,Cash,101,3875,283,272
694,25,Non-binary,Senior,Economics,1250,509,4288,679,125,98,92,120,39,109,146,188,Cash,185,4380,223,308
695,20,Non-binary,Freshman,Computer Science,567,906,3748,842,375,96,144,112,47,278,173,48,Mobile Payment App,220,3892,471,160
696,25,Female,Freshman,Computer Science,546,691,5457,978,286,100,237,60,58,206,158,137,Cash,216,5694,386,197
697,18,Non-binary,Senior,Economics,1169,836,5537,996,334,83,288,78,56,105,166,180,Mobile Payment App,222,5825,417,258
698,23,Non-binary,Freshman,Economics,834,607,3582,692,350,88,298,150,90,248,51,34,Credit/Debit Card,141,3880,438,184
699,19,Non-binary,Sophomore,Computer Science,1117,234,3366,940,212,87,121,139,41,298,119,158,Mobile Payment App,160,3487,299,297
700,25,Male,Freshman,Economics,677,894,5595,841,313,52,219,66,42,92,120,84,Mobile Payment App,162,5814,365,150
701,20,Non-binary,Freshman,Engineering,1433,964,4777,904,327,77,112,146,71,97,167,117,Cash,238,4889,404,263
702,20,Female,Freshman,Biology,889,633,3100,524,247,82,201,102,92,103,96,30,Credit/Debit Card,188,3301,329,132
703,21,Male,Junior,Biology,670,708,5934,649,386,146,182,132,48,175,59,155,Credit/Debit Card,107,6116,532,287
704,19,Male,Senior,Economics,645,616,4694,904,158,69,148,60,98,114,40,72,Credit/Debit Card,138,4842,227,132
705,21,Female,Junior,Psychology,1107,971,5997,720,289,124,210,35,51,157,101,168,Mobile Payment App,152,6207,413,203
706,22,Female,Sophomore,Psychology,750,572,4144,563,104,191,58,22,97,53,41,99,Cash,138,4202,295,121
707,21,Male,Sophomore,Biology,654,261,3359,802,124,56,57,41,56,111,62,196,Mobile Payment App,118,3416,180,237
708,20,Male,Freshman,Psychology,1141,57,5734,696,284,83,204,63,46,56,125,55,Cash,171,5938,367,118
709,22,Female,Sophomore,Biology,811,815,4724,815,300,120,126,22,93,104,119,152,Cash,212,4850,420,174
710,23,Female,Senior,Engineering,1452,520,3463,822,317,77,148,91,61,166,133,122,Mobile Payment App,194,3611,394,213
711,20,Non-binary,Junior,Psychology,1255,82,4739,465,400,68,190,24,70,246,132,160,Mobile Payment App,202,4929,468,184
712,24,Female,Junior,Computer Science,737,266,4964,780,303,111,199,62,94,193,97,57,Credit/Debit Card,191,5163,414,119
713,25,Male,Freshman,Engineering,1419,253,4089,444,220,148,114,65,29,136,34,35,Credit/Debit Card,63,4203,368,100
714,23,Non-binary,Freshman,Computer Science,815,76,4461,446,132,165,165,58,99,135,174,111,Cash,273,4626,297,169
715,25,Male,Senior,Engineering,1034,602,3444,517,238,110,255,86,77,281,150,56,Credit/Debit Card,227,3699,348,142
716,24,Non-binary,Freshman,Computer Science,1022,626,4797,413,139,167,165,75,57,219,126,43,Mobile Payment App,183,4962,306,118
717,23,Female,Sophomore,Biology,1341,839,3033,514,300,122,137,40,61,170,65,100,Cash,126,3170,422,140
718,20,Female,Senior,Engineering,999,919,5819,507,269,119,228,99,49,55,115,53,Mobile Payment App,164,6047,388,152
719,21,Male,Freshman,Psychology,1218,162,5467,684,280,131,186,103,85,91,89,126,Mobile Payment App,174,5653,411,229
720,24,Male,Sophomore,Economics,1332,705,3512,796,399,199,79,54,86,206,99,129,Cash,185,3591,598,183
721,20,Non-binary,Freshman,Biology,903,371,4230,798,319,60,90,101,24,147,70,170,Credit/Debit Card,94,4320,379,271
722,25,Non-binary,Freshman,Biology,932,887,5307,472,345,61,190,119,69,235,67,40,Mobile Payment App,136,5497,406,159
723,21,Female,Junior,Biology,634,330,5961,774,334,193,105,83,46,166,200,150,Cash,246,6066,527,233
724,25,Male,Senior,Biology,553,268,3130,736,140,68,150,99,33,288,51,199,Credit/Debit Card,84,3280,208,298
725,21,Male,Junior,Economics,547,678,5610,510,192,123,248,57,28,252,141,122,Cash,169,5858,315,179
726,18,Male,Senior,Computer Science,867,646,3014,944,320,165,232,96,73,298,142,183,Cash,215,3246,485,279
727,20,Male,Sophomore,Economics,863,844,3088,966,371,66,227,117,32,245,55,83,Mobile Payment App,87,3315,437,200
728,25,Non-binary,Sophomore,Biology,603,321,4879,420,231,126,248,74,32,172,80,193,Mobile Payment App,112,5127,357,267
729,21,Female,Junior,Computer Science,1480,555,3534,799,259,100,254,93,66,279,191,55,Credit/Debit Card,257,3788,359,148
730,18,Male,Freshman,Engineering,522,448,3744,706,174,80,284,90,61,228,66,181,Mobile Payment App,127,4028,254,271
731,22,Female,Junior,Biology,1376,510,3318,460,132,159,59,88,38,87,88,76,Cash,126,3377,291,164
732,22,Non-binary,Junior,Computer Science,1195,988,5729,455,115,117,74,129,93,154,155,190,Credit/Debit Card,248,5803,232,319
733,24,Non-binary,Freshman,Psychology,1223,785,3521,821,128,50,135,96,67,182,139,196,Credit/Debit Card,206,3656,178,292
734,21,Female,Junior,Computer Science,613,524,3640,834,219,57,71,89,39,241,66,93,Cash,105,3711,276,182
735,25,Non-binary,Sophomore,Engineering,844,766,4017,840,179,189,230,128,74,157,38,131,Mobile Payment App,112,4247,368,259
736,24,Female,Junior,Computer Science,620,192,4213,726,332,144,289,92,24,195,135,127,Cash,159,4502,476,219
737,22,Male,Freshman,Psychology,983,944,4216,978,114,103,58,123,72,114,76,63,Credit/Debit Card,148,4274,217,186
738,25,Male,Sophomore,Biology,996,250,5975,520,317,121,115,47,89,241,45,81,Mobile Payment App,134,6090,438,128
739,18,Male,Junior,Engineering,1106,794,3075,881,165,166,260,23,32,135,49,34,Cash,81,3335,331,57
740,23,Non-binary,Senior,Engineering,1032,809,4359,987,364,176,67,74,52,56,166,67,Credit/Debit Card,218,4426,540,141
741,20,Female,Senior,Biology,1419,991,4647,648,261,151,78,55,31,222,135,72,Credit/Debit Card,166,4725,412,127
742,22,Male,Sophomore,Economics,610,100,5142,473,298,164,139,45,67,77,32,113,Cash,99,5281,462,158
743,19,Female,Junior,Economics,1449,599,4790,885,109,57,293,70,90,267,164,33,Cash,254,5083,166,103
744,25,Male,Senior,Engineering,1270,504,3467,484,286,132,291,138,48,155,162,41,Credit/Debit Card,210,3758,418,179
745,18,Non-binary,Freshman,Computer Science,770,637,5055,814,273,55,140,134,61,131,128,39,Mobile Payment App,189,5195,328,173
746,25,Non-binary,Sophomore,Psychology,911,929,4595,578,338,122,165,25,87,275,176,94,Credit/Debit Card,263,4760,460,119
747,18,Female,Junior,Biology,1303,299,5031,701,242,183,249,103,79,107,74,52,Credit/Debit Card,153,5280,425,155
748,19,Non-binary,Junior,Engineering,1367,688,3603,452,372,162,177,29,66,243,30,155,Credit/Debit Card,96,3780,534,184
749,25,Non-binary,Sophomore,Computer Science,509,664,3449,779,243,153,281,108,52,70,145,192,Credit/Debit Card,197,3730,396,300
750,22,Male,Junior,Engineering,804,582,5299,892,153,173,199,32,84,289,126,46,Cash,210,5498,326,78
751,23,Female,Freshman,Computer Science,1268,271,5323,898,204,187,215,113,81,212,111,57,Credit/Debit Card,192,5538,391,170
752,22,Non-binary,Junior,Engineering,1492,82,3720,823,277,186,275,141,61,167,65,34,Cash,126,3995,463,175
753,23,Non-binary,Senior,Biology,1402,461,3827,904,321,138,147,114,33,198,188,179,Cash,221,3974,459,293
754,24,Non-binary,Junior,Psychology,673,606,4035,818,355,103,257,35,47,56,149,48,Credit/Debit Card,196,4292,458,83
755,22,Female,Sophomore,Biology,1174,962,4894,426,329,191,175,29,34,113,156,171,Cash,190,5069,520,200
756,20,Female,Freshman,Biology,635,827,4125,969,194,196,228,81,68,120,112,185,Credit/Debit Card,180,4353,390,266
757,23,Male,Sophomore,Engineering,792,584,4401,631,224,100,72,73,28,98,101,140,Credit/Debit Card,129,4473,324,213
758,22,Non-binary,Sophomore,Biology,998,928,3199,565,151,71,270,78,98,291,124,125,Mobile Payment App,222,3469,222,203
759,21,Non-binary,Junior,Biology,866,581,5775,773,267,100,252,32,26,97,42,82,Credit/Debit Card,68,6027,367,114
760,23,Non-binary,Sophomore,Biology,1408,566,3714,905,223,168,262,124,31,123,58,189,Cash,89,3976,391,313
761,25,Non-binary,Freshman,Biology,732,103,3335,742,395,154,245,130,73,178,100,80,Credit/Debit Card,173,3580,549,210
762,18,Non-binary,Junior,Engineering,1107,511,5507,738,144,131,213,53,38,156,137,47,Cash,175,5720,275,100
763,24,Female,Freshman,Engineering,1165,68,4126,859,333,196,124,109,49,185,179,29,Cash,228,4250,529,138
764,19,Female,Freshman,Computer Science,1316,867,4432,627,110,185,226,25,34,90,190,135,Credit/Debit Card,224,4658,295,160
765,21,Non-binary,Junior,Psychology,1471,280,4104,862,312,180,241,70,90,84,182,121,Cash,272,4345,492,191
766,18,Non-binary,Sophomore,Psychology,536,557,3744,498,375,128,185,63,97,298,45,36,Cash,142,3929,503,99
767,21,Male,Sophomore,Economics,1045,542,4154,937,157,164,246,25,29,99,46,77,Credit/Debit Card,75,4400,321,102
768,24,Non-binary,Junior,Biology,609,389,4329,934,393,68,77,33,96,235,48,186,Mobile Payment App,144,4406,461,219
769,20,Male,Senior,Psychology,581,964,4975,775,106,86,84,22,68,84,39,172,Mobile Payment App,107,5059,192,194
770,20,Female,Sophomore,Biology,1106,212,3376,461,130,175,231,135,37,59,197,168,Credit/Debit Card,234,3607,305,303
771,22,Non-binary,Freshman,Psychology,1316,710,3548,682,382,69,268,62,95,251,118,22,Credit/Debit Card,213,3816,451,84
772,19,Non-binary,Senior,Computer Science,574,103,5976,605,372,82,296,39,42,287,153,133,Credit/Debit Card,195,6272,454,172
773,19,Male,Sophomore,Biology,1115,12,3779,482,306,161,281,150,76,265,170,193,Mobile Payment App,246,4060,467,343
774,25,Male,Sophomore,Engineering,1257,45,3653,809,373,147,246,78,36,275,158,197,Credit/Debit Card,194,3899,520,275
775,23,Male,Junior,Economics,1069,130,5452,503,218,83,93,72,65,170,89,144,Cash,154,5545,301,216
776,22,Non-binary,Junior,Biology,757,471,3362,719,359,69,253,145,48,159,63,79,Credit/Debit Card,111,3615,428,224
777,21,Non-binary,Sophomore,Psychology,794,166,3624,908,371,73,222,103,41,283,152,109,Cash,193,3846,444,212
778,22,Male,Freshman,Computer Science,1139,845,4743,893,356,126,255,20,65,62,195,25,Credit/Debit Card,260,4998,482,45
779,23,Non-binary,Sophomore,Engineering,598,125,5824,413,278,130,91,88,60,152,82,27,Cash,142,5915,408,115
780,21,Female,Freshman,Economics,514,402,4642,494,395,92,56,104,66,98,131,135,Mobile Payment App,197,4698,487,239
781,23,Male,Freshman,Psychology,1479,418,3501,960,344,103,239,63,95,146,31,185,Mobile Payment App,126,3740,447,248
782,24,Non-binary,Junior,Biology,633,361,4634,685,252,128,268,107,74,139,190,23,Credit/Debit Card,264,4902,380,130
783,25,Non-binary,Senior,Biology,1437,150,4770,941,286,104,274,100,21,199,136,188,Credit/Debit Card,157,5044,390,288
784,22,Male,Sophomore,Biology,1135,279,4825,793,370,115,87,93,36,102,111,41,Credit/Debit Card,147,4912,485,134
785,21,Female,Junior,Engineering,1433,11,4125,832,313,123,187,134,62,61,200,102,Cash,262,4312,436,236
786,20,Female,Senior,Computer Science,824,93,3471,538,249,127,224,72,76,90,169,183,Credit/Debit Card,245,3695,376,255
787,24,Male,Junior,Psychology,967,288,4629,958,284,107,256,129,85,172,46,45,Mobile Payment App,131,4885,391,174
788,25,Male,Sophomore,Economics,1126,708,3830,405,343,159,226,98,24,197,162,160,Mobile Payment App,186,4056,502,258
789,21,Female,Sophomore,Psychology,885,513,5497,832,136,66,241,123,66,256,137,53,Credit/Debit Card,203,5738,202,176
790,25,Non-binary,Sophomore,Psychology,525,984,4547,670,359,148,192,38,56,162,31,86,Credit/Debit Card,87,4739,507,124
791,20,Male,Senior,Psychology,1009,14,4309,699,262,117,136,24,67,113,93,45,Mobile Payment App,160,4445,379,69
792,18,Non-binary,Senior,Psychology,1478,46,5450,957,360,77,112,22,50,265,183,92,Mobile Payment App,233,5562,437,114
793,19,Male,Sophomore,Computer Science,547,365,3465,645,316,58,186,120,54,196,135,119,Mobile Payment App,189,3651,374,239
794,22,Female,Freshman,Psychology,549,410,4796,749,304,167,82,142,100,271,169,153,Credit/Debit Card,269,4878,471,295
795,25,Female,Junior,Engineering,1326,611,5451,734,205,91,73,95,71,217,126,140,Mobile Payment App,197,5524,296,235
796,21,Male,Junior,Psychology,761,9,4836,594,375,53,256,55,41,50,126,35,Cash,167,5092,428,90
797,25,Non-binary,Senior,Computer Science,1344,494,5885,809,233,167,171,83,60,94,61,154,Cash,121,6056,400,237
798,22,Male,Junior,Biology,895,885,5489,456,343,157,177,123,75,77,156,139,Credit/Debit Card,231,5666,500,262
799,23,Non-binary,Junior,Economics,1036,811,4911,437,398,134,299,69,55,156,35,123,Mobile Payment App,90,5210,532,192
800,22,Non-binary,Senior,Computer Science,664,538,3008,417,236,75,136,131,60,243,156,116,Credit/Debit Card,216,3144,311,247
801,22,Non-binary,Senior,Computer Science,1403,789,5886,962,163,129,149,35,92,251,166,114,Cash,258,6035,292,149
802,23,Male,Senior,Engineering,1094,360,4651,622,242,90,98,103,77,138,111,190,Cash,188,4749,332,293
803,24,Female,Sophomore,Computer Science,789,413,3482,835,206,128,153,137,77,115,67,135,Mobile Payment App,144,3635,334,272
804,25,Non-binary,Sophomore,Biology,587,756,5035,797,291,171,283,89,26,238,74,119,Cash,100,5318,462,208
805,23,Male,Junior,Biology,509,395,3729,607,326,156,251,138,45,204,30,59,Mobile Payment App,75,3980,482,197
806,19,Male,Junior,Computer Science,1382,935,4650,853,203,180,230,33,55,297,43,122,Credit/Debit Card,98,4880,383,155
807,25,Non-binary,Senior,Engineering,1301,757,3811,664,121,115,239,126,48,121,172,114,Mobile Payment App,220,4050,236,240
808,23,Non-binary,Senior,Engineering,777,53,4935,505,268,181,194,79,60,71,54,65,Mobile Payment App,114,5129,449,144
809,19,Male,Sophomore,Psychology,505,646,4935,688,129,143,112,130,89,209,197,81,Cash,286,5047,272,211
810,24,Female,Junior,Engineering,866,796,4865,756,274,181,260,141,47,237,125,67,Cash,172,5125,455,208
811,19,Male,Freshman,Biology,1329,127,3321,836,277,92,108,27,67,251,87,87,Mobile Payment App,154,3429,369,114
812,20,Non-binary,Freshman,Economics,1372,297,4227,505,142,144,264,20,64,195,34,74,Cash,98,4491,286,94
813,24,Male,Junior,Economics,1004,883,5084,773,335,118,297,83,88,100,133,159,Credit/Debit Card,221,5381,453,242
814,23,Non-binary,Freshman,Biology,1415,153,4526,880,111,167,171,90,78,205,113,125,Cash,191,4697,278,215
815,20,Female,Junior,Psychology,639,13,4097,780,226,120,86,56,23,75,147,143,Mobile Payment App,170,4183,346,199
816,19,Male,Sophomore,Economics,1397,854,3186,552,258,123,127,61,21,127,71,186,Credit/Debit Card,92,3313,381,247
817,18,Female,Freshman,Economics,935,918,3901,724,128,122,56,39,53,152,108,134,Mobile Payment App,161,3957,250,173
818,18,Non-binary,Senior,Computer Science,882,524,4983,502,196,153,63,131,80,274,140,86,Credit/Debit Card,220,5046,349,217
819,20,Female,Freshman,Psychology,1398,912,4709,864,267,181,165,149,62,64,92,194,Mobile Payment App,154,4874,448,343
820,24,Non-binary,Sophomore,Biology,1461,403,3664,519,137,127,286,115,29,84,121,127,Cash,150,3950,264,242
821,24,Male,Senior,Engineering,1430,928,4968,682,336,89,135,76,66,289,82,95,Mobile Payment App,148,5103,425,171
822,22,Non-binary,Junior,Biology,953,925,5135,924,148,56,61,33,70,156,126,33,Credit/Debit Card,196,5196,204,66
823,19,Male,Junior,Psychology,1456,803,3431,636,136,177,131,112,28,249,116,128,Mobile Payment App,144,3562,313,240
824,22,Female,Junior,Computer Science,892,563,5529,437,230,85,57,49,27,151,44,199,Credit/Debit Card,71,5586,315,248
825,20,Non-binary,Sophomore,Psychology,539,494,4349,450,398,107,215,51,52,89,191,158,Mobile Payment App,243,4564,505,209
826,25,Non-binary,Junior,Economics,1024,756,4532,798,328,112,159,69,24,275,31,87,Cash,55,4691,440,156
827,22,Female,Senior,Biology,1405,544,5276,782,281,52,67,69,77,270,141,196,Mobile Payment App,218,5343,333,265
828,21,Male,Sophomore,Biology,691,710,3636,478,342,58,136,65,75,277,170,136,Credit/Debit Card,245,3772,400,201
829,19,Female,Junior,Biology,1157,333,3509,987,281,77,170,27,87,151,108,68,Mobile Payment App,195,3679,358,95
830,21,Non-binary,Junior,Computer Science,555,980,5657,707,302,195,207,141,91,126,180,67,Credit/Debit Card,271,5864,497,208
831,25,Non-binary,Senior,Biology,1245,803,4743,899,285,99,193,106,76,270,200,58,Credit/Debit Card,276,4936,384,164
832,25,Male,Senior,Biology,1227,408,5607,759,365,137,247,97,56,162,136,173,Credit/Debit Card,192,5854,502,270
833,18,Female,Freshman,Biology,825,403,5204,401,293,75,268,24,36,105,197,125,Mobile Payment App,233,5472,368,149
834,18,Female,Freshman,Economics,1359,468,3900,401,283,190,183,60,78,153,64,195,Credit/Debit Card,142,4083,473,255
835,22,Male,Junior,Economics,556,317,4429,834,166,130,174,86,46,222,33,145,Mobile Payment App,79,4603,296,231
836,20,Non-binary,Sophomore,Biology,1110,400,5325,586,400,62,120,54,30,294,125,167,Mobile Payment App,155,5445,462,221
837,21,Non-binary,Sophomore,Engineering,518,565,4940,783,157,97,129,122,20,71,175,115,Mobile Payment App,195,5069,254,237
838,19,Male,Senior,Engineering,932,611,4386,833,159,84,184,63,80,223,73,179,Mobile Payment App,153,4570,243,242
839,22,Female,Senior,Computer Science,683,651,5671,866,101,155,274,131,81,183,49,21,Mobile Payment App,130,5945,256,152
840,24,Male,Sophomore,Economics,1397,375,5325,637,139,83,217,55,48,293,195,71,Cash,243,5542,222,126
841,24,Non-binary,Freshman,Biology,1201,441,4212,864,140,83,97,85,89,90,115,141,Credit/Debit Card,204,4309,223,226
842,22,Non-binary,Junior,Psychology,1402,519,3124,886,381,193,120,64,68,153,151,118,Mobile Payment App,219,3244,574,182
843,25,Male,Senior,Economics,844,18,5452,910,220,71,109,75,91,244,105,123,Credit/Debit Card,196,5561,291,198
844,19,Female,Senior,Biology,1366,142,5925,614,304,163,240,127,83,108,163,152,Credit/Debit Card,246,6165,467,279
845,19,Male,Senior,Biology,923,734,4576,519,383,110,255,36,31,225,126,123,Credit/Debit Card,157,4831,493,159
846,21,Non-binary,Freshman,Biology,542,905,3434,987,297,160,189,150,26,286,185,86,Cash,211,3623,457,236
847,23,Female,Junior,Biology,1130,49,4833,415,100,160,262,98,32,99,117,149,Credit/Debit Card,149,5095,260,247
848,23,Non-binary,Junior,Biology,848,420,4663,950,173,167,101,108,29,54,159,128,Mobile Payment App,188,4764,340,236
849,19,Female,Junior,Engineering,1022,227,4305,982,296,73,252,149,79,206,152,162,Cash,231,4557,369,311
850,23,Non-binary,Junior,Economics,1189,980,4230,607,190,52,250,140,63,190,125,186,Credit/Debit Card,188,4480,242,326
851,18,Female,Sophomore,Economics,771,45,3719,821,189,173,295,60,38,258,107,187,Mobile Payment App,145,4014,362,247
852,25,Non-binary,Sophomore,Computer Science,1280,483,5743,678,206,54,82,49,85,256,187,29,Credit/Debit Card,272,5825,260,78
853,21,Male,Senior,Biology,933,988,4414,731,298,123,273,22,20,147,41,128,Cash,61,4687,421,150
854,24,Female,Sophomore,Computer Science,1257,795,5913,480,120,107,300,34,46,219,193,195,Mobile Payment App,239,6213,227,229
855,24,Female,Junior,Computer Science,1313,818,3335,845,363,190,212,69,37,103,186,79,Cash,223,3547,553,148
856,21,Male,Senior,Engineering,1034,927,4084,758,330,179,136,149,63,242,190,36,Mobile Payment App,253,4220,509,185
857,19,Male,Sophomore,Psychology,669,153,5509,741,335,78,170,69,68,296,73,166,Mobile Payment App,141,5679,413,235
858,19,Non-binary,Senior,Computer Science,728,814,3380,970,183,178,139,29,63,193,64,175,Mobile Payment App,127,3519,361,204
859,18,Male,Sophomore,Economics,569,513,5429,730,375,118,195,96,27,280,65,136,Mobile Payment App,92,5624,493,232
860,19,Male,Freshman,Engineering,960,179,5253,671,161,128,273,40,89,233,163,172,Cash,252,5526,289,212
861,18,Male,Freshman,Computer Science,1288,879,3829,982,191,65,86,107,80,97,137,134,Cash,217,3915,256,241
862,22,Female,Freshman,Engineering,556,904,3548,689,105,145,165,133,71,110,183,98,Cash,254,3713,250,231
863,23,Male,Senior,Engineering,1413,80,5976,836,386,194,266,29,99,213,109,158,Cash,208,6242,580,187
864,25,Non-binary,Senior,Biology,957,114,4956,923,326,150,199,49,88,246,118,78,Cash,206,5155,476,127
865,24,Non-binary,Freshman,Engineering,1084,582,3305,520,353,89,279,20,68,173,151,128,Mobile Payment App,219,3584,442,148
866,22,Male,Freshman,Psychology,1270,546,4425,559,304,160,79,95,99,191,70,189,Mobile Payment App,169,4504,464,284
867,24,Female,Sophomore,Computer Science,845,484,5594,793,130,51,153,77,47,89,151,63,Mobile Payment App,198,5747,181,140
868,21,Female,Freshman,Economics,1423,298,4484,439,312,157,118,56,43,235,188,129,Cash,231,4602,469,185
869,19,Male,Sophomore,Engineering,683,614,4718,643,132,186,83,31,68,85,181,96,Cash,249,4801,318,127
870,21,Non-binary,Freshman,Psychology,1309,561,5639,973,303,197,117,37,64,101,37,142,Mobile Payment App,101,5756,500,179
871,25,Male,Senior,Economics,888,218,4433,806,166,121,75,148,69,120,128,71,Credit/Debit Card,197,4508,287,219
872,24,Male,Sophomore,Psychology,1496,522,4678,640,212,140,200,22,69,98,162,70,Credit/Debit Card,231,4878,352,92
873,25,Male,Junior,Economics,965,465,4599,737,291,88,70,70,34,170,195,64,Cash,229,4669,379,134
874,20,Female,Junior,Biology,1329,533,3509,826,234,131,262,142,30,157,141,40,Cash,171,3771,365,182
875,21,Female,Sophomore,Engineering,1021,789,5681,844,235,99,167,115,53,127,131,190,Mobile Payment App,184,5848,334,305
876,18,Male,Freshman,Biology,501,422,5257,612,149,142,72,58,36,230,73,44,Mobile Payment App,109,5329,291,102
877,21,Female,Sophomore,Engineering,1223,302,3930,801,128,157,242,135,36,226,193,52,Mobile Payment App,229,4172,285,187
878,19,Male,Senior,Psychology,1495,1000,5857,980,228,126,82,39,72,144,78,190,Cash,150,5939,354,229
879,25,Male,Sophomore,Engineering,862,674,5473,575,338,54,264,39,60,262,180,196,Cash,240,5737,392,235
880,25,Male,Senior,Economics,1037,844,4320,894,393,176,280,73,21,241,44,196,Credit/Debit Card,65,4600,569,269
881,19,Male,Freshman,Engineering,505,293,5861,835,387,181,250,93,91,113,81,171,Cash,172,6111,568,264
882,24,Female,Senior,Psychology,1193,397,4234,761,120,75,92,104,28,216,101,116,Credit/Debit Card,129,4326,195,220
883,18,Non-binary,Sophomore,Psychology,1452,683,3275,586,327,65,176,32,40,205,160,58,Credit/Debit Card,200,3451,392,90
884,24,Non-binary,Sophomore,Psychology,1422,860,4913,892,149,115,159,133,90,227,92,147,Cash,182,5072,264,280
885,25,Male,Sophomore,Biology,717,197,5618,696,354,105,102,26,95,300,110,78,Cash,205,5720,459,104
886,24,Female,Junior,Economics,1333,538,5187,467,237,183,192,114,79,248,95,41,Credit/Debit Card,174,5379,420,155
887,24,Female,Sophomore,Psychology,978,974,4420,642,241,146,183,30,76,130,79,21,Cash,155,4603,387,51
888,25,Male,Freshman,Biology,1141,362,3197,926,397,121,150,122,69,258,173,120,Mobile Payment App,242,3347,518,242
889,22,Male,Sophomore,Biology,1399,611,4995,678,220,93,84,144,49,200,189,90,Mobile Payment App,238,5079,313,234
890,24,Male,Freshman,Psychology,1200,341,4547,778,330,51,129,24,75,238,192,153,Cash,267,4676,381,177
891,21,Non-binary,Sophomore,Economics,1053,64,4305,444,142,139,280,34,56,176,38,147,Mobile Payment App,94,4585,281,181
892,25,Non-binary,Junior,Biology,1118,584,4423,592,126,149,134,74,48,109,114,131,Cash,162,4557,275,205
893,21,Male,Junior,Biology,1094,321,3758,741,137,172,50,147,96,134,192,56,Mobile Payment App,288,3808,309,203
894,21,Non-binary,Freshman,Psychology,1252,226,4206,530,245,126,69,147,52,64,183,24,Credit/Debit Card,235,4275,371,171
895,18,Male,Junior,Psychology,686,252,5848,720,238,191,265,39,58,104,142,82,Mobile Payment App,200,6113,429,121
896,18,Male,Junior,Economics,513,123,5909,807,168,161,181,48,26,124,46,58,Cash,72,6090,329,106
897,25,Male,Junior,Biology,1174,75,4909,799,149,163,151,138,30,298,115,43,Cash,145,5060,312,181
898,24,Non-binary,Freshman,Psychology,1224,235,4645,913,209,101,77,85,97,78,80,111,Cash,177,4722,310,196
899,23,Non-binary,Junior,Biology,975,211,3952,769,131,134,283,65,91,127,151,79,Credit/Debit Card,242,4235,265,144
900,18,Male,Sophomore,Engineering,1435,950,3626,842,221,139,87,136,68,54,129,54,Mobile Payment App,197,3713,360,190
901,22,Male,Senior,Engineering,894,27,4496,718,373,144,254,139,82,286,134,198,Credit/Debit Card,216,4750,517,337
902,21,Non-binary,Junior,Economics,1168,81,5292,637,175,196,193,52,90,217,48,178,Cash,138,5485,371,230
903,25,Male,Freshman,Computer Science,1482,92,3987,540,194,125,193,143,78,268,63,199,Credit/Debit Card,141,4180,319,342
904,19,Non-binary,Sophomore,Psychology,1385,249,5745,452,399,170,71,145,37,231,114,154,Mobile Payment App,151,5816,569,299
905,20,Male,Sophomore,Computer Science,1476,832,5745,808,225,73,251,22,95,123,78,178,Mobile Payment App,173,5996,298,200
906,22,Female,Senior,Economics,812,101,4840,777,195,87,51,71,48,162,188,58,Mobile Payment App,236,4891,282,129
907,18,Male,Freshman,Psychology,1191,611,3373,673,327,62,164,133,26,229,107,152,Cash,133,3537,389,285
908,20,Male,Senior,Economics,1440,1000,3823,525,135,142,131,34,27,90,200,122,Cash,227,3954,277,156
909,24,Female,Sophomore,Biology,1447,246,4038,406,235,113,98,113,50,71,37,33,Credit/Debit Card,87,4136,348,146
910,21,Female,Freshman,Computer Science,1030,357,4883,806,100,99,87,46,38,155,169,91,Mobile Payment App,207,4970,199,137
911,23,Female,Senior,Engineering,1034,202,5347,558,381,116,271,67,44,228,124,184,Credit/Debit Card,168,5618,497,251
912,20,Female,Junior,Economics,1406,10,3674,967,303,94,286,61,61,121,181,62,Mobile Payment App,242,3960,397,123
913,21,Non-binary,Senior,Biology,1086,38,3425,605,381,53,171,129,24,165,136,67,Credit/Debit Card,160,3596,434,196
914,25,Female,Sophomore,Psychology,1334,320,4772,794,204,129,160,139,37,228,106,67,Mobile Payment App,143,4932,333,206
915,25,Female,Senior,Engineering,507,474,4996,750,181,107,156,79,27,122,39,87,Cash,66,5152,288,166
916,21,Male,Senior,Engineering,1483,892,4014,458,400,90,217,134,50,142,60,42,Mobile Payment App,110,4231,490,176
917,20,Non-binary,Sophomore,Economics,888,228,3253,539,207,182,241,71,41,254,125,48,Credit/Debit Card,166,3494,389,119
918,23,Non-binary,Freshman,Economics,1204,815,4350,871,166,120,275,87,77,237,85,21,Credit/Debit Card,162,4625,286,108
919,23,Male,Junior,Economics,1047,207,5892,667,161,197,255,53,96,168,105,168,Cash,201,6147,358,221
920,21,Male,Freshman,Psychology,1279,900,5478,815,336,136,154,145,81,236,108,186,Credit/Debit Card,189,5632,472,331
921,19,Female,Sophomore,Economics,613,543,5947,622,309,99,151,94,36,83,199,141,Mobile Payment App,235,6098,408,235
922,18,Male,Senior,Computer Science,1280,550,4843,500,112,99,119,67,70,141,97,109,Credit/Debit Card,167,4962,211,176
923,25,Male,Sophomore,Economics,696,976,5246,475,258,162,87,67,68,232,72,132,Mobile Payment App,140,5333,420,199
924,20,Female,Senior,Economics,1191,315,4490,476,270,152,169,129,100,75,193,157,Credit/Debit Card,293,4659,422,286
925,24,Female,Freshman,Biology,1287,239,3301,493,252,98,246,36,70,282,134,114,Mobile Payment App,204,3547,350,150
926,23,Female,Junior,Engineering,1391,362,4261,697,269,108,105,145,43,100,39,144,Cash,82,4366,377,289
927,23,Non-binary,Sophomore,Economics,1345,291,4809,686,173,132,229,115,40,207,63,57,Credit/Debit Card,103,5038,305,172
928,19,Non-binary,Junior,Computer Science,1344,825,3106,563,333,142,129,111,47,96,94,153,Cash,141,3235,475,264
929,23,Non-binary,Junior,Economics,779,708,3808,876,391,94,298,34,34,192,87,107,Mobile Payment App,121,4106,485,141
930,23,Female,Senior,Economics,1123,490,5507,932,370,141,233,91,61,258,139,187,Mobile Payment App,200,5740,511,278
931,22,Male,Senior,Economics,1038,686,4766,929,366,133,70,93,90,74,118,106,Credit/Debit Card,208,4836,499,199
932,22,Female,Senior,Computer Science,595,995,3971,572,111,79,291,24,71,244,61,198,Mobile Payment App,132,4262,190,222
933,25,Non-binary,Freshman,Engineering,1345,295,4585,621,285,101,270,115,55,211,55,107,Cash,110,4855,386,222
934,19,Non-binary,Junior,Computer Science,534,546,4102,520,371,196,106,75,56,239,45,122,Cash,101,4208,567,197
935,24,Non-binary,Senior,Computer Science,1176,326,4890,837,245,93,134,78,81,54,107,40,Cash,188,5024,338,118
936,20,Non-binary,Sophomore,Biology,836,105,5807,419,243,149,89,72,52,71,74,143,Mobile Payment App,126,5896,392,215
937,18,Female,Freshman,Biology,1047,15,4342,620,359,195,212,63,94,193,141,48,Credit/Debit Card,235,4554,554,111
938,24,Female,Sophomore,Engineering,865,907,5189,936,161,115,284,61,100,234,129,163,Mobile Payment App,229,5473,276,224
939,18,Non-binary,Junior,Psychology,1148,565,3353,613,218,159,271,92,67,235,122,186,Credit/Debit Card,189,3624,377,278
940,21,Female,Senior,Engineering,696,715,5238,710,195,133,98,54,66,294,41,197,Credit/Debit Card,107,5336,328,251
941,19,Female,Freshman,Economics,778,741,5664,558,398,171,183,71,52,148,83,138,Credit/Debit Card,135,5847,569,209
942,22,Non-binary,Senior,Psychology,1140,598,5623,665,278,183,236,110,22,238,194,22,Credit/Debit Card,216,5859,461,132
943,22,Female,Sophomore,Computer Science,557,351,3510,857,112,158,269,40,78,267,31,146,Cash,109,3779,270,186
944,24,Male,Sophomore,Computer Science,948,741,5923,954,265,181,81,59,71,216,157,33,Mobile Payment App,228,6004,446,92
945,24,Female,Freshman,Engineering,1249,574,4477,653,111,182,112,92,84,241,112,196,Mobile Payment App,196,4589,293,288
946,24,Non-binary,Sophomore,Economics,1092,988,4819,768,240,158,109,111,33,236,137,58,Credit/Debit Card,170,4928,398,169
947,20,Female,Junior,Computer Science,717,958,5667,447,304,194,95,71,49,193,94,103,Mobile Payment App,143,5762,498,174
948,19,Female,Sophomore,Computer Science,857,615,3851,487,255,95,287,31,46,299,93,74,Cash,139,4138,350,105
949,18,Non-binary,Senior,Biology,1021,581,4690,502,222,161,98,80,73,56,188,85,Credit/Debit Card,261,4788,383,165
950,22,Female,Sophomore,Psychology,1056,669,5378,596,278,179,223,47,87,135,55,51,Mobile Payment App,142,5601,457,98
951,25,Male,Freshman,Economics,758,387,4974,534,101,76,62,65,27,120,160,26,Credit/Debit Card,187,5036,177,91
952,21,Non-binary,Freshman,Economics,653,639,5045,496,336,84,236,115,34,220,169,125,Cash,203,5281,420,240
953,21,Male,Sophomore,Computer Science,643,218,4138,793,271,182,52,55,99,79,45,91,Credit/Debit Card,144,4190,453,146
954,25,Male,Freshman,Engineering,668,893,3446,653,347,88,276,73,95,73,152,35,Cash,247,3722,435,108
955,25,Female,Sophomore,Psychology,645,79,3830,940,249,63,69,61,40,74,76,75,Mobile Payment App,116,3899,312,136
956,20,Female,Senior,Psychology,1020,522,3874,408,150,162,168,129,98,255,138,174,Credit/Debit Card,236,4042,312,303
957,20,Non-binary,Junior,Computer Science,1128,458,5302,602,270,65,299,143,58,218,138,142,Cash,196,5601,335,285
958,22,Male,Senior,Economics,1186,650,4387,798,139,59,160,109,21,275,119,32,Mobile Payment App,140,4547,198,141
959,23,Female,Senior,Psychology,528,573,4286,889,209,136,149,105,80,151,46,73,Mobile Payment App,126,4435,345,178
960,25,Male,Senior,Computer Science,774,799,4397,629,163,75,183,39,33,54,136,125,Cash,169,4580,238,164
961,22,Male,Senior,Economics,1236,255,3954,600,274,115,84,55,23,297,31,39,Credit/Debit Card,54,4038,389,94
962,24,Non-binary,Sophomore,Biology,938,612,3797,928,190,65,79,111,45,196,113,171,Mobile Payment App,158,3876,255,282
963,22,Non-binary,Senior,Computer Science,1169,588,4110,508,104,159,242,30,78,105,163,195,Mobile Payment App,241,4352,263,225
964,25,Male,Freshman,Computer Science,1061,333,5826,949,250,138,158,57,20,265,193,103,Mobile Payment App,213,5984,388,160
965,24,Non-binary,Sophomore,Economics,514,158,3039,506,361,84,158,132,49,104,159,99,Cash,208,3197,445,231
966,19,Male,Junior,Engineering,1015,493,5435,827,369,147,121,87,49,289,121,74,Mobile Payment App,170,5556,516,161
967,18,Male,Junior,Computer Science,743,104,3493,726,223,105,96,73,37,275,158,75,Mobile Payment App,195,3589,328,148
968,21,Male,Sophomore,Engineering,913,70,4183,714,268,88,198,87,31,69,39,177,Cash,70,4381,356,264
969,24,Non-binary,Junior,Engineering,1142,946,4748,867,264,166,125,99,69,287,84,135,Credit/Debit Card,153,4873,430,234
970,25,Female,Senior,Psychology,868,670,3274,443,308,120,61,70,96,86,199,127,Mobile Payment App,295,3335,428,197
971,19,Non-binary,Sophomore,Engineering,1464,17,3939,490,357,87,131,97,67,168,87,135,Credit/Debit Card,154,4070,444,232
972,21,Female,Senior,Psychology,1260,617,4060,799,244,62,193,107,62,285,180,130,Cash,242,4253,306,237
973,19,Male,Junior,Computer Science,1326,817,5451,453,172,87,62,112,70,220,93,32,Cash,163,5513,259,144
974,18,Female,Senior,Computer Science,1219,671,4152,700,335,152,296,98,86,77,82,27,Cash,168,4448,487,125
975,19,Non-binary,Freshman,Computer Science,1038,823,5211,576,207,92,263,54,26,270,123,165,Credit/Debit Card,149,5474,299,219
976,25,Male,Junior,Biology,1418,510,3832,976,370,117,218,89,89,283,185,60,Mobile Payment App,274,4050,487,149
977,18,Female,Junior,Engineering,1385,13,4384,678,253,119,76,113,50,229,74,169,Mobile Payment App,124,4460,372,282
978,23,Female,Freshman,Computer Science,553,118,5030,960,304,135,212,105,54,147,118,183,Mobile Payment App,172,5242,439,288
979,20,Male,Senior,Economics,1013,227,4119,805,366,62,191,135,60,84,151,172,Mobile Payment App,211,4310,428,307
980,18,Non-binary,Senior,Engineering,1019,589,5357,828,247,65,112,58,92,170,30,126,Mobile Payment App,122,5469,312,184
981,24,Non-binary,Junior,Computer Science,669,7,4461,828,266,59,60,129,27,131,75,165,Credit/Debit Card,102,4521,325,294
982,19,Female,Freshman,Computer Science,933,698,4156,780,371,80,235,84,82,269,50,170,Mobile Payment App,132,4391,451,254
983,20,Female,Junior,Psychology,1166,671,3244,528,164,117,238,127,56,243,84,108,Cash,140,3482,281,235
984,25,Non-binary,Freshman,Economics,1197,652,4424,637,248,186,186,82,58,254,116,27,Mobile Payment App,174,4610,434,109
985,19,Female,Senior,Biology,973,695,4709,555,114,93,190,121,70,190,129,178,Cash,199,4899,207,299
986,23,Female,Junior,Computer Science,1381,696,4387,646,171,142,97,109,83,216,88,190,Cash,171,4484,313,299
987,22,Male,Junior,Psychology,1082,221,4524,533,276,131,242,109,21,217,49,182,Credit/Debit Card,70,4766,407,291
988,23,Male,Senior,Engineering,1160,168,3395,810,105,182,51,26,64,279,74,105,Cash,138,3446,287,131
989,22,Female,Junior,Computer Science,1011,753,3523,475,392,187,298,99,73,125,93,31,Cash,166,3821,579,130
990,20,Non-binary,Senior,Psychology,1412,155,5576,443,305,119,136,120,41,290,30,91,Mobile Payment App,71,5712,424,211
991,24,Non-binary,Junior,Psychology,1391,259,3572,755,136,55,86,62,66,187,153,23,Cash,219,3658,191,85
992,20,Male,Freshman,Economics,1293,672,5635,435,389,192,87,23,64,67,77,137,Credit/Debit Card,141,5722,581,160
993,20,Male,Freshman,Psychology,1380,594,3658,739,277,187,92,144,69,283,68,21,Mobile Payment App,137,3750,464,165
994,22,Male,Senior,Psychology,764,286,5430,589,387,61,68,46,96,86,46,85,Mobile Payment App,142,5498,448,131
995,22,Female,Senior,Biology,1346,520,3688,969,152,194,151,42,38,252,65,163,Cash,103,3839,346,205
996,19,Female,Senior,Biology,1407,560,3380,508,265,52,206,40,98,274,84,135,Mobile Payment App,182,3586,317,175
997,20,Male,Junior,Economics,957,393,3497,723,339,139,69,112,46,284,57,28,Mobile Payment App,103,3566,478,140
998,22,Non-binary,Senior,Economics,1174,612,3649,543,237,123,200,129,90,190,101,65,Mobile Payment App,191,3849,360,194
999,24,Non-binary,Sophomore,Computer Science,541,640,5965,609,270,191,215,139,43,281,88,145,Cash,131,6180,461,284
